target_chainseq	templates_alignfile	targetid	template_pdb_dict
AGSHSMRYFFTSVSRPGRGEPRFIAVGYVDDTQFVRFDSDAASQRMEPRAPWIEQEGPEYWDGETRKVKAHSQTHRVDLGTLRGCYNQSEAGSHTVQRMYGCDVGSDWRFLRGYHQYAYDGKDYIALKEDLRSWTAADMCAQTTKHKWEAAHVAEQLRAYLEGTCVEWLRRYLENGKETLQRTDA/NLVPMVATV	initial_guess_benchmark/alignment/6Q3K_0_with_pep.tsv	6Q3K_0/6Q3K_0	initial_guess_benchmark/pandora/6Q3K_0/no_modelling_output_dict.json
GTHSLKYVYTGVSRGIDFPEFTAVGMVDDGQFMYFDSNSMKAVPKTEWIRQNEGADYWDRQTQVLIGAHQVFKDSIQIVMERFNQSKGVHTWQNMYGCELNDDGTTQGFYQYAYDGEDFVSLDKNTLTWTAANPQAVITKHKWEALAVAEQNKGYLENTCIEWLKKYVAYGKDTLERKVSPQVSL/FANFCLMMI	initial_guess_benchmark/alignment/6LBE_0_with_pep.tsv	6LBE_0/6LBE_0	initial_guess_benchmark/pandora/6LBE_0/no_modelling_output_dict.json
GSHSMRYFYTSVSRPGRGEPRFIAVGYVDDTQFVRFDSDAASQRMEPRAPWIEQEGPEYWDGETRKVKAHSQTHRVDLGTLRGYYNQSEAGSHTVQRMYGCDVGSDWRFLRGYHQYAYDGKDYIALKEDLRSWTAADMAAQTTKHKWEAAHVAEQLRAYLEGTCVEWLRRYLENGKETLQRTDAP/KQWLVWLFL	initial_guess_benchmark/alignment/6UJO_0_with_pep.tsv	6UJO_0/6UJO_0	initial_guess_benchmark/pandora/6UJO_0/no_modelling_output_dict.json
GSHSMRYFHTSVSRPGRGEPRFITVGYVDDTLFVRFDSDAASPREEPRAPWIEQEGPEYWDRETQICKAKAQTDREDLRTLLRYYNQSEAGSHTLQNMYGCDVGPDGRLLRGYHQHAYDGKDYIALNEDLSSWTAADTAAQITQRKWEAARVAEQLRAYLEGECVEWLRRYLENGKETLQRADPP/GRLNEPIKV	initial_guess_benchmark/alignment/6Y29_0_with_pep.tsv	6Y29_0/6Y29_0	initial_guess_benchmark/pandora/6Y29_0/no_modelling_output_dict.json
GSHSMRYFYTSVSRPGRGEPRFIAVGYVDDTQFVRFDSDAASQRMEPRAPWIEQEGPEYWDGETRKVKAHSQTHRVDLGTLRGYYNQSEAGSHTVQRMYGCDVGSDWRFLRGYHQYAYDGKDYIALKEDLRSWTAADMAAQTTKHKWEAAHVAEQLRAYLEGTCVEWLRRYLENGKETLQRTDAP/KQWLVWLFL	initial_guess_benchmark/alignment/6UK4_0_with_pep.tsv	6UK4_0/6UK4_0	initial_guess_benchmark/pandora/6UK4_0/no_modelling_output_dict.json
GSHSMRYFYTSVSRPGRGEPRFISVGYVDDTQFVRFDSDAASPREEPRAPWIEQEGPEYWDRNTQIYKAQAQTDRESLRNLRGYYNQSEAGSHTLQSMYGCDVGPDGRLLRGHDQYAYDGKDYIALNEDLRSWTAADTAAQITQRKWEAAREAEQRRAYLEGECVEWLRRYLENGKDKLERADPP/SPKLHFYYL	initial_guess_benchmark/alignment/7LGT_0_with_pep.tsv	7LGT_0/7LGT_0	initial_guess_benchmark/pandora/7LGT_0/no_modelling_output_dict.json
GSHSMRYFFTSVSRPGRGEPRFIAVGYVDDTQFVRFDSDAASQRMEPRAPWIEQEGPEYWDGETRKVKAHSQTHRVDLGTLRGYYNQSEAGSHTVQRMYGCDVGSDWRFLRGYHQYAYDGKDYIALKEDLRSWTAADMAAQTTKHKWEAAHVAEQLRAYLEGTCVEWLRRYLENGKETLQRTDAP/LLFGYPVYV	initial_guess_benchmark/alignment/6UZ1_0_with_pep.tsv	6UZ1_0/6UZ1_0	initial_guess_benchmark/pandora/6UZ1_0/no_modelling_output_dict.json
GSHSMRYFFTSVSRPGRGEPRFIAVGYVDDTQFVRFDSDAASQRMEPRAPWIEQEGPEYWDGETRKVKAHSQTHRVDLGTLRGYYNQSEAGSHTVQRMYGCDVGSDWRFLRGYHQYAYDGKDYIALKEDLRSWTAADMAAQTTKHKWEAAHVAEQLRAYLEGTCVEWLRRYLENGKETLQRTDAP/IMDQVPFSV	initial_guess_benchmark/alignment/6VM8_0_with_pep.tsv	6VM8_0/6VM8_0	initial_guess_benchmark/pandora/6VM8_0/no_modelling_output_dict.json
GPHSLSYFYTAVSRPDRGDSRFIAVGYVDDTQFVRFDNYAPNPRMEPRVPWIQQEGQEYWDRETRNVKETAQTYGVGLNTLRGYYNQSEAGSHTLQSMYGCYLGPDGLLLHGYRQDAYDGADYIALNEDLRSWTAADMAAQITKRKWEAADEAERARSYLQGLCVESLRRYLEMGKDTLQRAEPP/MTAHITVPY	initial_guess_benchmark/alignment/6KWL_0_with_pep.tsv	6KWL_0/6KWL_0	initial_guess_benchmark/pandora/6KWL_0/no_modelling_output_dict.json
GSHSMRYFHTSVSRPGRGEPRFITVGYVDDTLFVRFDSDAASPREEPRAPWIEQEGPEHWDRETQICKAKAQTDREDLRTLLRYYNQSEAGSHTLQNMYGCDVGPDGRLLRGYHQDAYDGKDYIALNEDLSSWTAADTAAQITQRKWEAARVAEQLRAYLEGECVEWLRRYLENGKETLQRADPP/LRNQSVFNF	initial_guess_benchmark/alignment/6PZ5_0_with_pep.tsv	6PZ5_0/6PZ5_0	initial_guess_benchmark/pandora/6PZ5_0/no_modelling_output_dict.json
GSHSMRYFDTAMSRPGRGEPRFISVGYVDDTQFVRFDSDAASPRMEPRAPWIEQEGPEYWDRNTQIFKTNTQTDRESLRNLRGYYNQSEAGSHTLQSMYGCDVGPDGRLLRGHNQYAYDGKDYIALNEDLRSWTAADTAAQITQRKWEAARVAEQDRAYLEGTCVEWLRRYLENGKDTLERADPP/ELRSRYWAI	initial_guess_benchmark/alignment/7NUI_0_with_pep.tsv	7NUI_0/7NUI_0	initial_guess_benchmark/pandora/7NUI_0/no_modelling_output_dict.json
GSHSMRYFYTAMSRPGRGEPRFIAVGYVDDTQFVRFDSDAASPRMAPRAPWIEQEGPEYWDGETRNMKASAQTYRENLRIALRYYNQSEAGSHIIQVMYGCDVGPDGRLLRGHDQSAYDGKDYIALNEDLSSWTAADTAAQITQRKWEAARVAEQLRAYLEGLCVEWLRRYLENGKETLQRADPP/LSSPVTKSW	initial_guess_benchmark/alignment/5VUD_0_with_pep.tsv	5VUD_0/5VUD_0	initial_guess_benchmark/pandora/5VUD_0/no_modelling_output_dict.json
GSHSMRYFYTAMSRPGRGEPRFIAVGYVDDTQFVRFDSDAASPRMAPRAPWIEQEGPEYWDGETRNMKASAQTYRENLRIALRYYNQSEAGSHIIQVMYGCDVGPDGRLLRGHDQSAYDGKDYIALNEDLSSWTAADTAAQITQRKWEAARVAEQLRAYLEGLCVEWLRRYLENGKETLQRADPP/TSMSFVPRPW	initial_guess_benchmark/alignment/6D29_0_with_pep.tsv	6D29_0/6D29_0	initial_guess_benchmark/pandora/6D29_0/no_modelling_output_dict.json
GSHSMRYFYTAMSRPGRGEPRFIAVGYVDDTQFVRFDSDAASPRTEPRAPWIEQEGPEYWDGETRNMKASAQTYRENLRIALRYYNQSEAGSHIIQRMYGCDLGPDGRLLRGHDQSAYDGKDYIALNEDLSSWTAADTAAQITQRKWEAARVAEQLRAYLEGLCVEWLRRYLENGKETLQRADPP/LSSPVTKSW	initial_guess_benchmark/alignment/5VWH_0_with_pep.tsv	5VWH_0/5VWH_0	initial_guess_benchmark/pandora/5VWH_0/no_modelling_output_dict.json
GSHSLKYFHTSVSRPGRGEPRFISVGYVDDTQFVRFDNDAASPRMVPRAPWMEQEGSEYWDRETRSARDTAQIFRVNLRTLRGYYNQSEAGSHTLQWMHGCELGPDGRFLRGYEQFAYDGKDYLTLNEDLRSWTAVDTAAQISEQKSNDASEAEHQRAYLEDTCVEWLHKYLEKGKETLLHLEPP/RLPAKAPLF	initial_guess_benchmark/alignment/6GHN_0_with_pep.tsv	6GHN_0/6GHN_0	initial_guess_benchmark/pandora/6GHN_0/no_modelling_output_dict.json
GSHSMRYFFTSVSRPGRGEPRFIAVGYVDDTQFVRFDSDAASQRMEPRAPWIEQEGPEYWDGETRKVKAHSQTHRVDLGTLRGYYNQSEAGSHTVQRMYGCDVGSDWRFLRGYHQYAYDGKDYIALKEDLRSWTAADMAAQTTKHKWEAAHVAEQLRAYLEGTCVEWLRRYLENGKETLQRTDAP/HMTEVVRHC	initial_guess_benchmark/alignment/6VR5_0_with_pep.tsv	6VR5_0/6VR5_0	initial_guess_benchmark/pandora/6VR5_0/no_modelling_output_dict.json
GSHSMRYFDTAMSRPGRGEPRFISVGYVDDTQFVRFDSDAPWIEQEGPEYWDRNTQIFKTNTQTDRESLRNLRGYYNQSEAGSHTLQSMYGCDVGPDGRLLRGHNQYAYDGKDYIALNEDLRSWTAADTAAQITQRKWEAARVAEQDRAYLEGTCVEWLRRYLENGKDTLERADPPKTHVTHHPI/QIKVRVDMV	initial_guess_benchmark/alignment/5WMR_0_with_pep.tsv	5WMR_0/5WMR_0	initial_guess_benchmark/pandora/5WMR_0/no_modelling_output_dict.json
GSHSMRYFYTSVSRPGRGEPRFISVGYVDDTQFVRFDSDAASPREEPRAPWIEQEGPEYWDRNTQIYKAQAQTDRESLRNLRGYYNQSEAGSHTLQSMYGCDVGPDGRLLRGHDQYAYDGKDYIALNEDLRSWTAADTAAQITQRKWEAAREAEQRRAYLEGECVEWLRRYLENGKDKLERADPP/RPPIFIRRL	initial_guess_benchmark/alignment/6VMX_0_with_pep.tsv	6VMX_0/6VMX_0	initial_guess_benchmark/pandora/6VMX_0/no_modelling_output_dict.json
GSHSMRYFSTSVSRPGRGEPRFIAVGYVDDTQFVRFDSDAASQRMEPRAPWIEQEGPEYWDEETGKVKAHSQTDRENLRIALRYYNQSEAGSHTLQMMFGCDVGSDGRFLRGYHQYAYDGKDYIALKEDLRSWTAADMAAQITKRKWEAAHVAEQQRAYLEGTCVDGLRRYLENGKETLQRTDPP/IYFSPIRVTF	initial_guess_benchmark/alignment/7JYU_0_with_pep.tsv	7JYU_0/7JYU_0	initial_guess_benchmark/pandora/7JYU_0/no_modelling_output_dict.json
GSHSMRYFHTSVSRPGRGEPRFISVGYVDDTQFVRFDSDAASPRTEPRAPWIEQEGPEYWDRETQISKTNTQTYREDLRTLLRYYNQSEAGSHTIQRMSGCDVGPDGRLLRGYNQFAYDGKDYIALNEDLSSWTAADTAAQITQRKWEAARVAEQDRAYLEGTCVEWLRRYLENGKETLQRADPP/FEDLRVLSF	initial_guess_benchmark/alignment/6MT6_0_with_pep.tsv	6MT6_0/6MT6_0	initial_guess_benchmark/pandora/6MT6_0/no_modelling_output_dict.json
GSHSMRYFSTSVSRPGSGEPRFIAVGYVDDTQFVRFDSDAASQRMEPRAPWIEQEGPEYWDQETRNVKAHSQTDRENLGTLRGYYNQSEAGSHTIQIMYGCDVGSDGRFLRGYEQHAYDGKDYIALNEDLRSWTAADMAAQITQRKWEAARRAEQLRAYLEGTCVEWLRRYLENGKETLQRTDPP/QIMYNYPAM	initial_guess_benchmark/alignment/6J29_0_with_pep.tsv	6J29_0/6J29_0	initial_guess_benchmark/pandora/6J29_0/no_modelling_output_dict.json
GSHSMRYFFTSVSRPGRGEPRFIAVGYVDDTQFVRFDSDAASQRMEPRAPWIEQEGPEYWDGETRKVKAHSQTHRVDLGTLRGYYNQSEAGSHTVQRMYGCDVGSDWRFLRGYHQYAYDGKDYIALKEDLRSWTAADMAAQTTKHKWEAAHVAEQLRAYLEGTCVEWLRRYLENGKETLQRTDAP/ILKEPVHGV	initial_guess_benchmark/alignment/6EWA_0_with_pep.tsv	6EWA_0/6EWA_0	initial_guess_benchmark/pandora/6EWA_0/no_modelling_output_dict.json
GSHSMRYFYTSVSRPGRGEPRFISVGYVDDTQFVRFDSDAASPREEPRAPWIEQEGPEYWDRNTQIYKAQAQTDRESLRNLRGYYNQSEAGSHTLQSMYGCDVGPDGRLLRGHDQYAYDGKDYIALNEDLRSWTAADTAAQITQRKWEAAREAEQRRAYLEGECVEWLRRYLENGKDKLERADPP/SPNGTIQNIL	initial_guess_benchmark/alignment/6UJ7_0_with_pep.tsv	6UJ7_0/6UJ7_0	initial_guess_benchmark/pandora/6UJ7_0/no_modelling_output_dict.json
GSHSMRYFYTAMSRPGRGEPRFIAVGYVDDTQFVRFDSDAASPRMAPRAPWIEQEGPEYWDGETRNMKASAQTYRENLRIALRYYNQSEAGSHIIQVMYGCDVGPDGRLLRGHNQYAYDGKDYIALNEDLSSWTAADTAAQITQRKWEAARVAEQLRAYLEGLCVEWLRRYLENGKETLQRADPP/LSSPVTKSF	initial_guess_benchmark/alignment/6V3J_0_with_pep.tsv	6V3J_0/6V3J_0	initial_guess_benchmark/pandora/6V3J_0/no_modelling_output_dict.json
GSHSMRYFYTSVSRPGRGEPRFIAVGYVDDTQFVRFDSDAASQRMEPRAPWIEQEGPEYWDGETRKVKAHSQTHRVDLGTLRGYYNQSEAGSHTVQRMYGCDVGSDWRFLRGYHQYAYDGKDYIALKEDLRSWTAADMAAQTTKHKWEAAHVAEQLRAYLEGTCVEWLRRYLENGKETLQRTDAP/KQWLVWLFL	initial_guess_benchmark/alignment/6P64_0_with_pep.tsv	6P64_0/6P64_0	initial_guess_benchmark/pandora/6P64_0/no_modelling_output_dict.json
GSHSMRYFHTSVSRPGRGEPRFISVGYVDDTQFVRFDSDAASPRTEPRAPWIEQEGPEYWDRETQISKTNTQTYREDLRTLLRYYNQSEAGSHTIQRMSGCDVGPDGRLLRGYNQFAYDGKDYIALNEDLSSWTAADTAAQITQRKWEAARVAEQDRAYLEGTCVEWLRRYLENGKETLQRADPP/FEDLRVSSF	initial_guess_benchmark/alignment/6MT4_0_with_pep.tsv	6MT4_0/6MT4_0	initial_guess_benchmark/pandora/6MT4_0/no_modelling_output_dict.json
GSHSMRYFHTSVSRPGRGEPRFITVGYVDDTLFVRFDSDAASPREEPRAPWIEQEGPEYWDRETQICKAKAQTDREDLRTLLRYYNQSEAGSHTLQNMYGCDVGPDGRLLRGYHQDAYDGKDYIALNEDLSSWTAADTAAQITQRKWEAARVAEQLRAYLEGECVEWLRRYLENGKETLQRADPP/GRLNAPIKV	initial_guess_benchmark/alignment/6Y26_0_with_pep.tsv	6Y26_0/6Y26_0	initial_guess_benchmark/pandora/6Y26_0/no_modelling_output_dict.json
MGPHSLSYFSTAVSRPDRGDSRFIAVGYVDDTQFVRFDSDAPNPRMEPRAPWIQQEGQEYWDRNTRNVMGSAQINRVNLKTLRGYYNQSEAGSHTLQWMYGCYLGPDGLLLRGYDQFAYDGADYLALNEDLRSWTAADMAAQISKRKWEAADAAEHWRSYLQGTCVESLRRYLQMGKDTLQRAEP/EFEDLTFLA	initial_guess_benchmark/alignment/5NPZ_0_with_pep.tsv	5NPZ_0/5NPZ_0	initial_guess_benchmark/pandora/5NPZ_0/no_modelling_output_dict.json
GSHSMRYFFTSVSRPGRGEPRFIAVGYVDDTQFVRFDSDAASQRMEPRAPWIEQEGPEYWDGETRKVKAHSQTHRVDLGTLRGYYNQSEAGSHTVQRMYGCDVGSDWRFLRGYHQYAYDGKDYIALKEDLRSWTAADMAAQTTKHKWEAAHVAEQLRAYLEGTCVEWLRRYLENGKETLQRTDAP/AVYDGREHTV	initial_guess_benchmark/alignment/6TRN_0_with_pep.tsv	6TRN_0/6TRN_0	initial_guess_benchmark/pandora/6TRN_0/no_modelling_output_dict.json
GSHSMRYFHTSVSRPGRGEPRFITVGYVDDTLFVRFDSDAASPREEPRAPWIEQEGPEYWDRETQICKAKAQTDREDLRTLLRYYNQSEAGSHTLQNMYGCDVGPDGRLLRGYHQDAYDGKDYIALNEDLSSWTAADTAAQITQRKWEAARVAEQLRAYLEGECVEWLRRYLENGKETLQRADPP/GRLNQPIKV	initial_guess_benchmark/alignment/6Y2A_0_with_pep.tsv	6Y2A_0/6Y2A_0	initial_guess_benchmark/pandora/6Y2A_0/no_modelling_output_dict.json
GSHSMRYFHTSVSRPGRGEPRFITVGYVDDTLFVRFDSDAASPREEPRAPWIEQEGPEYWDRETQICKAKAQTDREDLRTLLRYYNQSEAGSHTLQNMYGCDVGPDGRLLRGYHQDAYDGKDYIALNEDLSSWTAADTAAQITQRKWEAARVAEQLRAYLEGECVEWLRRYLENGKETLQRADPP/LRNQSVFNF	initial_guess_benchmark/alignment/6PYJ_0_with_pep.tsv	6PYJ_0/6PYJ_0	initial_guess_benchmark/pandora/6PYJ_0/no_modelling_output_dict.json
GSHSMRYFFTSVSRPGRGEPRFIAVGYVDDTQFVRFDSDAASQRMEPRAPWIEQEGPEYWDGETRKVKAHSQTHRVDLGTLRGYYNQSEAGSHTVQRMYGCDVGSDWRFLRGYHQYAYDGKDYIALKEDLRSWTAADMAAQTTKHKWEAAHVAEQLRAYLEGTCVEWLRRYLENGKETLQRTDAP/MTSAIGILPV	initial_guess_benchmark/alignment/6G3J_0_with_pep.tsv	6G3J_0/6G3J_0	initial_guess_benchmark/pandora/6G3J_0/no_modelling_output_dict.json
GPHSLSYFYTAVSRPDRGDSRFIAVGYVDDTQFVRFDNYAPNPRMEPRVPWIQQEGQEYWDRETRNVKETAQTYGVGLNTLRGYYNQSEAGSHTLQSMYGCYLGPDGLLLHGYRQDAYDGADYIALNEDLRSWTAADMAAQITKRKWEAADEAERRRSYLQGLCVESLRRYLEMGKDTLQRAEPP/MTAHITVPY	initial_guess_benchmark/alignment/6KWK_0_with_pep.tsv	6KWK_0/6KWK_0	initial_guess_benchmark/pandora/6KWK_0/no_modelling_output_dict.json
HSMRYFYTAVSRPGRGEPRFIAVGYVDDTQFVQFDSDAASPRGEPRAPWVEQEGPEYWDRETQKYKRQAQTDRVSLRNLRGYYNQSEAGSHTLQRMYGCDLGPDGRLLRGYNQFAYDGKDYIALNEDLRSWTAADKAAQITQRKWEAAREAEQRRAYLEGTCVEWLRRYLENGKKTLQRAEHPKT/GADGVGKSA	initial_guess_benchmark/alignment/6ULR_0_with_pep.tsv	6ULR_0/6ULR_0	initial_guess_benchmark/pandora/6ULR_0/no_modelling_output_dict.json
SHSMRYFYTSVSRPGRGEPRFISVGYVDDTQFVRFDSDAASPREEPRAPWIEQEGPEYWDRNTQIYKAQAQTDRESLRNLRGYYNQSEAGSHTLQSMYGCDVGPDGRLLRGHDQYAYDGKDYIALNEDLRSWTAADTAAQITQRKWEAAREAEQRRAYLEGECVEWLRRYLENGKDKLERADPPK/SPNGTIRNIL	initial_guess_benchmark/alignment/6UJ8_0_with_pep.tsv	6UJ8_0/6UJ8_0	initial_guess_benchmark/pandora/6UJ8_0/no_modelling_output_dict.json
GSHSMRYFYTAMSRPGRGEPRFIAVGYVDDTQFVRFDSDAASPRMAPRAPWIEQEGPEYWDGETRNMKASAQTYRENLRIALRYYNQSEAGSHIIQVMYGCDVGPDGRLLRGHNQYAYDGKDYIALNEDLSSWTAADTAAQITQRKWEAARVAEQLRAYLEGLCVEWLRRYLENGKETLQRADPP/LSSPVTKSF	initial_guess_benchmark/alignment/6V2Q_0_with_pep.tsv	6V2Q_0/6V2Q_0	initial_guess_benchmark/pandora/6V2Q_0/no_modelling_output_dict.json
GSHSMRYFSTSVSRPGRGEPRFIAVGYVDDTQFVRFDSDAASQRMEPRAPWIEQEGPEYWDEETGKVKAHSQTDRENLRIALRYYNQSEAGSHTLQMMFGCDVGSDGRFLRGYHQYAYDGKDYIALKEDLRSWTAADMAAQITKRKWEAAHVAEQQRAYLEGTCVDGLRRYLENGKETLQRTDPP/RYPLTFGW	initial_guess_benchmark/alignment/7K81_0_with_pep.tsv	7K81_0/7K81_0	initial_guess_benchmark/pandora/7K81_0/no_modelling_output_dict.json
GSHSMRYFFTSVSRPGRGEPRFIAVGYVDDTQFVRFDSDAASQRMEPRAPWIEQEGPEYWDGETRKVKAHSQTHRVDLGTLRGYYNQSEAGSHTVQRMYGCDVGSDWRFLRGYHQYAYDGKDYIALKEDLRSWTAADMAAQTTKHKWEAAHVAEQLRAYLEGTCVEWLRRYLENGKETLQRTDAP/ELAGIGILTV	initial_guess_benchmark/alignment/5NQK_0_with_pep.tsv	5NQK_0/5NQK_0	initial_guess_benchmark/pandora/5NQK_0/no_modelling_output_dict.json
GSHSMRYFFTSVSRPGRGEPRFIAVGYVDDTQFVRFDSDAASQRMEPRAPWIEQEGPEYWDGETRKVKAHSQTHRVDLGTLRGYYNQSEAGSHTVQRMYGCDVGSDWRFLRGYHQYAYDGKDYIALKEDLRSWTAADMAAQTTKHKWEAAHVAEQLRAYLEGTCVEWLRRYLENGKETLQRTDAP/LLWNGPMHV	initial_guess_benchmark/alignment/6SS9_0_with_pep.tsv	6SS9_0/6SS9_0	initial_guess_benchmark/pandora/6SS9_0/no_modelling_output_dict.json
GSHSMRYFYTSVSRPGRGEPRFIAVGYVDDTQFVRFDSDAASQRMEPRAPWIEQEGPEYWDGETRKVKAHSQTHRVDLGTLRGYYNQSEAGSHTVQRMYGCDVGSDWRFLRGYHQYAYDGKDYIALKEDLRSWTAADMAAQTTKHKWEAAHVAEQLRAYLEGTCVEWLRRYLENGKETLQRTDAP/KQWLVWLLL	initial_guess_benchmark/alignment/6UJQ_0_with_pep.tsv	6UJQ_0/6UJQ_0	initial_guess_benchmark/pandora/6UJQ_0/no_modelling_output_dict.json
EFELHTLRYISTAMTDPGPGQPWYVDVGYVDGELFTHYNSTARRAVPRTEWIAANTDQQYWDSETQTSQRTEQIDRDGLGTLQRRYNQTGGSHTVQLMYGCDILEDGTIRGYSQDAYDGRDFIAFDKDTMTFTAAVPEAVPTKRKWEEGDYAEGLKQYLEETCVEWLRRYVEYGKAELGRRERPE/RREVHTYY	initial_guess_benchmark/alignment/6IRL_0_with_pep.tsv	6IRL_0/6IRL_0	initial_guess_benchmark/pandora/6IRL_0/no_modelling_output_dict.json
GSHSMRYFYTSVSRPGRGEPRFIAVGYVDDTQFVRFDSDAASQRMEPRAPWIEQEGPEYWDQETRNVKAQSQTDRVDLGTLRGYYNQSEDGSHTIQIMYGCDVGPDGRFLRGYRQDAYDGKDYIALNEDLRSWTAADMAAQITKRKWEAAHAAEQQRAYLEGRCVEWLRRYLENGKETLQRTDPP/NSASFSTFK	initial_guess_benchmark/alignment/7M8T_0_with_pep.tsv	7M8T_0/7M8T_0	initial_guess_benchmark/pandora/7M8T_0/no_modelling_output_dict.json
GSHSMRYFSTSVSRPGSGEPRFIAVGYVDDTQFVRFDSDAASQRMEPRAPWIEQEGPEYWDQETRNVKAHSQTDRENLGTLRGYYNQSEAGSHTIQIMYGCDVGSDGRFLRGYEQHAYDGKDYIALNEDLRSWTAADMAAQITQRKWEAARRAEQLRAYLEGTCVEWLRRYLENGKETLQRTDPP/AIFQSSMTK	initial_guess_benchmark/alignment/6J1V_0_with_pep.tsv	6J1V_0/6J1V_0	initial_guess_benchmark/pandora/6J1V_0/no_modelling_output_dict.json
GSHSMRYFFTSVSRPGRGEPRFIAVGYVDDTQFVRFDSDAASQRMEPRAPWIEQEGPEYWDGETRKVKAHSQTHRVDLGTLRGYYNQSEAGSHTVQRMYGCDVGSDWRFLRGYHQYAYDGKDYIALKEDLRSWTAADMAAQTTKHKWEAAHVAEQLRAYLEGTCVEWLRRYLENGKETLQRTDAP/SLLMWITQV	initial_guess_benchmark/alignment/6RPB_0_with_pep.tsv	6RPB_0/6RPB_0	initial_guess_benchmark/pandora/6RPB_0/no_modelling_output_dict.json
GSHSMRYFYTAMSRPGRGEPRFIAVGYVDDTQFVRFDSDAASPRMAPRAPWIEQEGPEYWDGETRNMKASAQTYRENLRIALRYYNQSEAGSHIIQVMYGCDVGPDGRLLRGHDQSAYDGKDYIALNEDLSSWTAADTAAQITQRKWEAARVAEQLRAYLEGLCVEWLRRYLENGKETLQRADPP/ASLNLPAVSW	initial_guess_benchmark/alignment/6V2O_0_with_pep.tsv	6V2O_0/6V2O_0	initial_guess_benchmark/pandora/6V2O_0/no_modelling_output_dict.json
GSHSMRYFYTSVSRPGRGEPRFISVGYVDDTQFVRFDSDAASPREEPRAPWIEQEGPEYWDRNTQIYKAQAQTDRESLRNLRGYYNQSEAGSHTLQSMYGCDVGPDGRLLRGHDQYAYDGKDYIALNEDLRSWTAADTAAQITQRKWEAAREAEQRRAYLEGECVEWLRRYLENGKDKLERADPP/IPRRNVATL	initial_guess_benchmark/alignment/7LFZ_0_with_pep.tsv	7LFZ_0/7LFZ_0	initial_guess_benchmark/pandora/7LFZ_0/no_modelling_output_dict.json
GSHSMRYFSTSVSRPGRGEPRFIAVGYVDDTQFVRFDSDAASQRMEPRAPWIEQEGPEYWDEETGKVKAHSQTDRENLRIALRYYNQSEAGSHTLQMMFGCDVGSDGRFLRGYHQYAYDGKDYIALKEDLRSWTAADMAAQITKRKWEAAHVAEQQRAYLEGTCVDGLRRYLENGKETLQRTDPP/TYQWIIRNW	initial_guess_benchmark/alignment/7JYW_0_with_pep.tsv	7JYW_0/7JYW_0	initial_guess_benchmark/pandora/7JYW_0/no_modelling_output_dict.json
ELHTLRYISTAMTDPGPGQPWYVDVGYVDGELFTHYNSTARRAVPRTEWIAANTDQQYWDSETQTSQRTEQIDRDGLGTLQRRYNQTGGSHTVQLMYGCDILEDGTIRGYSQDAYDGRDFIAFDKDTMTFTAAVPEAVPTKRKWEEGDYAEGLKQYLEETCVEWLRRYVEYGKAELGRRERPEVR/RRREQTDY	initial_guess_benchmark/alignment/6LHH_0_with_pep.tsv	6LHH_0/6LHH_0	initial_guess_benchmark/pandora/6LHH_0/no_modelling_output_dict.json
GSHSMRYFFTSVSRPGRGEPRFIAVGYVDDTQFVRFDSDAASQRMEPRAPWIEQEGPEYWDGETRKVKAHSQTHRVDLGTLRGYYNQSEAGSHTVQRMYGCDVGSDWRFLRGYHQYAYDGKDYIALKEDLRSWTAADMAAQTTKHKWEAAHVAEQLRAYLEGTCVEWLRRYLENGKETLQRTDAP/RMFPNAPYL	initial_guess_benchmark/alignment/6RSY_0_with_pep.tsv	6RSY_0/6RSY_0	initial_guess_benchmark/pandora/6RSY_0/no_modelling_output_dict.json
GSHSMRYFDTAMSRPGRGEPRFISVGYVDDTQFVRFDSDAASPREEPRAPWIEQEGPEYWDRNTQIFKTNTQTDRCSLRNLRGYYNQSEAGSHTLQSMYGCDVGPDGRLLRGHNQYAYDGKDYIALNEDLRSWTAADTAAQITQRKWEAARVAEQDRAYLEGTCVEWLRRYLENGKDTLERADPP/AAAKKKYCL	initial_guess_benchmark/alignment/6P2C_0_with_pep.tsv	6P2C_0/6P2C_0	initial_guess_benchmark/pandora/6P2C_0/no_modelling_output_dict.json
GSHSMRYFFTSVSRPGRGEPRFIAVGYVDDTQFVRFDSDAASQRMEPRAPWIEQEGPEYWDGETRKVKAHSQTHRVDLGTLRGYYNQSEAGSHTVQRMYGCDVGSDWRFLRGYHQYAYDGKDYIALKEDLRSWTAADMAAQTTKHKWEAAHVAEQLRAYLEGTCVEWLRRYLENGKETLQRTDAP/SLSKILDTV	initial_guess_benchmark/alignment/6R2L_0_with_pep.tsv	6R2L_0/6R2L_0	initial_guess_benchmark/pandora/6R2L_0/no_modelling_output_dict.json
GSHSMRYFHTSVSRPGRGEPRFISVGYVDGTQFVRFDSDAASPRTEPRAPWIEQEGPEYWDRNTQISKTNTQTYRESLRNLRGYYNQSEAGSHTLQRMYGCDVGPDGRLLRGHDQSAYDGKDYIALNEDLSSWTAADTAAQITQRKWEAARVAEQLRAYLEGTCVEWLRRHLENGKETLQRADPP/FEDLRVLSF	initial_guess_benchmark/alignment/6MT3_0_with_pep.tsv	6MT3_0/6MT3_0	initial_guess_benchmark/pandora/6MT3_0/no_modelling_output_dict.json
SHSMRYFYTAVSRPGRGEPRFIAVGYVDDTQFVQFDSDAASPRGEPRAPWVEQEGPEYWDRETQKYKRQAQTDRVSLRNLRGYYNQSEAGSHTLQRMYGCDLGPDGRLLRGYNQFAYDGKDYIALNEDLRSWTAADKAAQITQRKWEAAREAEQRRAYLEGTCVEWLRRYLENGKKTLQRAEHPK/GADGVGKSAL	initial_guess_benchmark/alignment/6UON_0_with_pep.tsv	6UON_0/6UON_0	initial_guess_benchmark/pandora/6UON_0/no_modelling_output_dict.json
PHSLRYFVTAVSRPGLGEPRFIAVGYVDDTQFVRFDSDADNPRFEPRAPWMEQEGPEYWEEQTQRAKSDEQWFRVSLRTAQRYYNQSKGGSHTFQRMFGCDVGSDWRLLRGYHQFAYDGRDYIALNEDLKTWTAADTAALITRRKWEQAGDAEYYRAYLEGECVEWLRRYLELGNETLLRTDSPK/YQSGLSIVM	initial_guess_benchmark/alignment/5TRZ_0_with_pep.tsv	5TRZ_0/5TRZ_0	initial_guess_benchmark/pandora/5TRZ_0/no_modelling_output_dict.json
GSHSMRYFFTSVSRPGRGEPRFIAVGYVDDTQFVRFDSDAASQRMEPRAPWIEQEGPEYWDGETRKVKAHSQTHRVDLGTLRGYYNQSEAGSHTVQRMYGCDVGSDWRFLRGYHQYAYDGKDYIALKEDLRSWTAADMAAQTTKHKWEAAHVAEQLRAYLEGTCVEWLRRYLENGKETLQRTDAP/AAGIGILTV	initial_guess_benchmark/alignment/6D78_0_with_pep.tsv	6D78_0/6D78_0	initial_guess_benchmark/pandora/6D78_0/no_modelling_output_dict.json
GSHSMRYFSTSVSRPGRGEPRFIAVGYVDDTQFVRFDSDAASQRMEPRAPWIEQEGPEYWDEETGKVKAHSQTDRENLRIALRYYNQSEAGSHTLQMMFGCDVGSDGRFLRGYHQYAYDGKDYIALKEDLRSWTAADMAAQITKRKWEAAHVAEQQRAYLEGTCVDGLRRYLENGKETLQRTDPP/TYQWVLKNL	initial_guess_benchmark/alignment/6XQA_0_with_pep.tsv	6XQA_0/6XQA_0	initial_guess_benchmark/pandora/6XQA_0/no_modelling_output_dict.json
SHSMRYFYTAVSRPGRGEPRFIAVGYVDDTQFVQFDSDAASPRGEPRAPWVEQEGPEYWDRETQKYKRQAQTDRVSLRNLRGYYNQSEAGSHTLQRMYGCDLGPDGRLLRGYNQFAYDGKDYIALNEDLRSWTAADKAAQITQRKWEAAREAEQRRAYLEGTCVEWLRRYLENGKKTLQRAEHPK/GADGVGKSA	initial_guess_benchmark/alignment/6ULN_0_with_pep.tsv	6ULN_0/6ULN_0	initial_guess_benchmark/pandora/6ULN_0/no_modelling_output_dict.json
GPHSMRYFETAVSRPGLEEPRYISVGYVDNKEFVRFDSDAENPRYEPRAPWMEQEGPEYWERETQKAKGQEQWFRVSLRNLLGYYNQSAGGSHTLQQMSGCDLGSDWRLLRGYLQFAYEGRDYIALNEDLKTWTAADMAAQITRRKWEQSGAAEHYKAYLEGECVEWLHRYLKNGLRTDSPKAHV/SGPSNTPPEI	initial_guess_benchmark/alignment/6H6D_0_with_pep.tsv	6H6D_0/6H6D_0	initial_guess_benchmark/pandora/6H6D_0/no_modelling_output_dict.json
GSHSMRYFHTSVSRPGRGEPRFISVGYVDDTQFVRFDSDAASPRTEPRAPWIEQEGPEYWDRETQISKTNTQTYREDLRTLLRYYNQSEAGSHTIQRMSGCDVGPDGRLLRGYNQFAYDGKDYIALNEDLSSWTAADTAAQITQRKWEAARVAEQDRAYLEGTCVEWLRRYLENGKETLQRADPP/FEDLRLLSF	initial_guess_benchmark/alignment/6MT5_0_with_pep.tsv	6MT5_0/6MT5_0	initial_guess_benchmark/pandora/6MT5_0/no_modelling_output_dict.json
GSHSMRYFDTAMSRPGRGEPRFISVGYVDDTQFVRFDSDAASPREEPRAPWIEQEGPEYWDRNTQIFKTNTQTDRCSLRNLRGYYNQSEAGSHTLQSMYGCDVGPDGRLLRGHNQYAYDGKDYIALNEDLRSWTAADTAAQITQRKWEAARVAEQDRAYLEGTCVEWLRRYLENGKDTLERADPP/AAAKKKYCL	initial_guess_benchmark/alignment/6P27_0_with_pep.tsv	6P27_0/6P27_0	initial_guess_benchmark/pandora/6P27_0/no_modelling_output_dict.json
GSHSMRYFYTSVSRPGRGEPRFIAVGYVDDTQFVRFDSDAASQRMEPRAPWIEQEGPEYWDQETRNVKAQSQTDRVDLGTLRGYYNQSEDGSHTIQIMYGCDVGPDGRFLRGYRQDAYDGKDYIALNEDLRSWTAADMAAQITKRKWEAAHAAEQQRAYLEGRCVEWLRRYLENGKETLQRTDPP/ATIGTAMYK	initial_guess_benchmark/alignment/6JOZ_0_with_pep.tsv	6JOZ_0/6JOZ_0	initial_guess_benchmark/pandora/6JOZ_0/no_modelling_output_dict.json
GSHSMRYFYTAMSRPGRGEPRFIAVGYVDDTQFVRFDSDAASPRMAPRAPWIEQEGPEYWDGETRNMKASAQTYRENLRIALRYYNQSEAGSHIIQVMYGCDVGPDGRLLRGHNQYAYDGKDYIALNEDLSSWTAADTAAQITQRKWEAARVAEQLRAYLEGLCVEWLRRYLENGKETLQRADPP/LTVQVARVW	initial_guess_benchmark/alignment/5VWD_0_with_pep.tsv	5VWD_0/5VWD_0	initial_guess_benchmark/pandora/5VWD_0/no_modelling_output_dict.json
AGPHSMRYFETAVSRPGLGEPRYISVGYVDNKEFVRFDSDAENPRYEPQAPWMEQEGPEYWERITQIAKGQEQWFRVNLRTLLGYYNQSAGGTHTLQWMYGCDVGSDGRLLRGYEQFAYDGCDYIALNEDLKTWTAADMAAQITRRKWEQAGAAEYYRAYLEGECVEWLHRYLKNGNATLLRTDS/SPSYAYHQF	initial_guess_benchmark/alignment/6L9N_0_with_pep.tsv	6L9N_0/6L9N_0	initial_guess_benchmark/pandora/6L9N_0/no_modelling_output_dict.json
GSHSMRYFFTSVSRPGRGEPRFIAVGYVDDTQFVRFDSDAASQRMEPRAPWIEQEGPEYWDGETRKVKAHSQTHRVDLGTLRGYYNQSEAGSHTVQRMYGCDVGSDWRFLRGYHQYAYDGKDYIALKEDLRSWTAADMAAQTTKHKWEAAHVAEQLRAYLEGTCVEWLRRYLENGKETLQRTDAP/ITDQVPFSV	initial_guess_benchmark/alignment/6VMA_0_with_pep.tsv	6VMA_0/6VMA_0	initial_guess_benchmark/pandora/6VMA_0/no_modelling_output_dict.json
GSHSMRYFFTSVSRPGRGEPRFIAVGYVDDTQFVRFDSDAASQRMEPRAPWIEQEGPEYWDGETRKVKAHSQTHRVDLGTLRGYYNQSEAGSHTVQRMYGCDVGSDWRFLRGYHQYAYDGKDYIALKEDLRSWTAADMAAQTTKHKWEAAHVAEQLRAYLEGTCVEWLRRYLENGKETLQRTDAP/LLLPLLPPLSP	initial_guess_benchmark/alignment/7MJ7_0_with_pep.tsv	7MJ7_0/7MJ7_0	initial_guess_benchmark/pandora/7MJ7_0/no_modelling_output_dict.json
GSHSMRYFFTSVSRPGRGEPRFIAVGYVDDTQFVRFDSDAASQRMEPRAPWIEQEGPEYWDGETRKVKAHSQTHRVDLGTLRGYYNQSEAGSHTVQRMYGCDVGSDWRFLRGYHQYAYDGKDYIALKEDLRSWTAADMAAQTTKHKWEAAHVAEQLRAYLEGTCVEWLRRYLENGKETLQRTDAP/LLWAGPMAV	initial_guess_benchmark/alignment/6SS7_0_with_pep.tsv	6SS7_0/6SS7_0	initial_guess_benchmark/pandora/6SS7_0/no_modelling_output_dict.json
GSHSMRYFFTSVSRPGRGEPRFIAVGYVDDTQFVRFDSDAASQRMEPRAPWIEQEGPEYWDGETRKVKAHSQTHRVDLGTLRGYYNQSEAGSHTVQRMYGCDVGSDWRFLRGYHQYAYDGKDYIALKEDLRSWTAADMAAQTTKHKWEAAHVAEQLRAYLEGTCVEWLRRYLENGKETLQRTDAP/YLVVVGAVGV	initial_guess_benchmark/alignment/6O51_0_with_pep.tsv	6O51_0/6O51_0	initial_guess_benchmark/pandora/6O51_0/no_modelling_output_dict.json
GSHSMRYFSTSVSRPGSGEPRFIAVGYVDDTQFVRFDSDAASQRMEPRAPWIEQEGPEYWDQETRNVKAHSQTDRENLGTLRGYYNQSEAGSHTIQIMYGCDVGSDGRFLRGYEQHAYDGKDYIALNEDLRSWTAADMAAQITQRKWEAARRAEQLRAYLEGTCVEWLRRYLENGKETLQRTDPP/CTELKLSDY	initial_guess_benchmark/alignment/6J2A_0_with_pep.tsv	6J2A_0/6J2A_0	initial_guess_benchmark/pandora/6J2A_0/no_modelling_output_dict.json
GSHSMRYFFTSVSRPGRGEPRFIAVGYVDDTQFVRFDSDAASQRMEPRAPWIEQEGPEYWDGETRKVKAHSQTHRVDLGTLRGYYNQSEAGSHTVQRMYGCDVGSDWRFLRGYHQYAYDGKDYIALKEDLRSWTAADMAAQTTKHKWEAAHVAEQLRAYLEGTCVEWLRRYLENGKETLQRTDAP/KLVALGINAV	initial_guess_benchmark/alignment/5YXN_0_with_pep.tsv	5YXN_0/5YXN_0	initial_guess_benchmark/pandora/5YXN_0/no_modelling_output_dict.json
SHSMRYFYTAVSRPGRGEPRFIAVGYVDDTQFVQFDSDAASPRGEPRAPWVEQEGPEYWDRETQKYKRQAQTDRVSLRNLRGYYNQSEAGSHTLQRMYGCDLGPDGRLLRGYNQFAYDGKDYIALNEDLRSWTAADKAAQITQRKWEAAREAEQRRAYLEGTCVEWLRRYLENGKKTLQRAEHPK/GADGVGKSAL	initial_guess_benchmark/alignment/6ULK_0_with_pep.tsv	6ULK_0/6ULK_0	initial_guess_benchmark/pandora/6ULK_0/no_modelling_output_dict.json
GSHSMRYFFTSVSRPGRGEPRFIAVGYVDDTQFVRFDSDAASQRMEPRAPWIEQEGPEYWDGETRKVKAHSQTHRVDLGTLRGYYNQSEAGSHTVQRMYGCDVGSDWRFLRGYHQYAYDGKDYIALKEDLRSWTAADMAAQTTKHKWEAAHVAEQLRAYLEGTCVEWLRRYLENGKETLQRTDAP/AAGIGILTV	initial_guess_benchmark/alignment/6EQA_0_with_pep.tsv	6EQA_0/6EQA_0	initial_guess_benchmark/pandora/6EQA_0/no_modelling_output_dict.json
GSHSMRYFFTSVSRPGRGEPRFIAVGYVDDTQFVRFDSDAASQRMEPRAPWIEQEGPEYWDGETRKVKAHSQTHRVDLGTLRGYYNQSEAGSHTVQRMYGCDVGSDWRFLRGYHQYAYDGKDYIALKEDLRSWTAADMAAQTTKHKWEAAHVAEQLRAYLEGTCVEWLRRYLENGKETLQRTDAP/LLGWVFAQV	initial_guess_benchmark/alignment/6Z9W_0_with_pep.tsv	6Z9W_0/6Z9W_0	initial_guess_benchmark/pandora/6Z9W_0/no_modelling_output_dict.json
GSHSMRYFFTSVSRPGRGEPRFIAVGYVDDTQFVRFDSDAASQRMEPRAPWIEQEGPEYWDGETRKVKAHSQTHRVDLGTLRGYYNQSEAGSHTVQRMYGCDVGSDWRFLRGYHQYAYDGKDYIALKEDLRSWTAADMAAQTTKHKWEAAHVAEQLRAYLEGTCVEWLRRYLENGKETLQRTDAP/ITDQVPFSV	initial_guess_benchmark/alignment/6VM7_0_with_pep.tsv	6VM7_0/6VM7_0	initial_guess_benchmark/pandora/6VM7_0/no_modelling_output_dict.json
GSHSMRYFYTAMSRPGRGEPRFIAVGYVDDTQFVRFDSDAASPRMAPRAPWIEQEGPEYWDGETRNMKASAQTYRENLRIALRYYNQSEAGSHIIQVMYGCDVGPDGRLLRGHDQSAYDGKDYIALNEDLSSWTAADTAAQITQRKWEAARVAEQLRAYLEGLCVEWLRRYLENGKETLQRADPP/GSFDYSGVHLW	initial_guess_benchmark/alignment/6D2R_0_with_pep.tsv	6D2R_0/6D2R_0	initial_guess_benchmark/pandora/6D2R_0/no_modelling_output_dict.json
GSHSMRYFFTSVSRPGRGEPRFIAVGYVDDTQFVRFDSDAASQRMEPRAPWIEQEGPEYWDGETRKVKAHSQTHRVDLGTLRGYYNQSEAGSHTVQRMYGCDVGSDWRFLRGYHQYAYDGKDYIALKEDLRSWTAADMAAQTTKHKWEAAHVAEQLRAYLEGTCVEWLRRYLENGKETLQRTDAP/HMTEVVRHC	initial_guess_benchmark/alignment/6VRN_0_with_pep.tsv	6VRN_0/6VRN_0	initial_guess_benchmark/pandora/6VRN_0/no_modelling_output_dict.json
GSHSMRYFFTSVSRPGRGEPRFIAVGYVDDTQFVRFDSDAASQRMEPRAPWIEQEGPEYWDGETRKVKAHSQTHRVDLGTLRGYYNQSEAGSHTVQRMYGCDVGSDWRFLRGYHQYAYDGKDYIALKEDLRSWTAADMAAQTTKHKWEAAHVAEQLRAYLEGTCVEWLRRYLENGKETLQRTDAP/ILNAMIAKI	initial_guess_benchmark/alignment/6PTB_0_with_pep.tsv	6PTB_0/6PTB_0	initial_guess_benchmark/pandora/6PTB_0/no_modelling_output_dict.json
GSHSMRYFDTAMSRPGRGEPRFISVGYVDDTQFVRFDSDAASPREEPRAPWIEQEGPEYWDRNTQIFKTNTQTDRCSLRNLRGYYNQSEAGSHTLQSMYGCDVGPDGRLLRGHNQYAYDGKDYIALNEDLRSWTAADTAAQITQRKWEAARVAEQDRAYLEGTCVEWLRRYLENGKDTLERADPP/AAAKKGYCL	initial_guess_benchmark/alignment/6P2F_0_with_pep.tsv	6P2F_0/6P2F_0	initial_guess_benchmark/pandora/6P2F_0/no_modelling_output_dict.json
SGSHSMRYFFTSVSRPGRGEPRFIAVGYVDDTQFVRFDSDAASQRMEPRAPWIEQEGPEYWDQETRNVKAQSQTDRVDLGTLRGYYNQSEAGSHTIQIMYGCDVGSDGRFLRGYRQDAYDGKDYIALNEDLRSWTAADMAAQITKRKWEAAHEAEQLRAYLDGTCVEWLRRYLENGKETLQRTDP/TTAPFLSGK	initial_guess_benchmark/alignment/6O9C_0_with_pep.tsv	6O9C_0/6O9C_0	initial_guess_benchmark/pandora/6O9C_0/no_modelling_output_dict.json
GSHSMRYFFTSVSRPGRGEPRFIAVGYVDDTQFVRFDSDAASQRMEPRAPWIEQEGPEYWDGETRKVKAHSQTHRVDLGTLRGYYNQSEAGSHTVQRMYGCDVGSDWRFLRGYHQYAYDGKDYIALKEDLRSWTAADMAAQTTKHKWEAAHVAEQLRAYLEGTCVEWLRRYLENGKETLQRTDAP/KLVVVAVGV	initial_guess_benchmark/alignment/6O4Z_0_with_pep.tsv	6O4Z_0/6O4Z_0	initial_guess_benchmark/pandora/6O4Z_0/no_modelling_output_dict.json
GSHSMRYFDTAMSRPGRGEPRFISVGYVDDTQFVRFDSDAASPREEPRAPWIEQEGPEYWDRNTQIFKTNTQTDRCSLRNLRGYYNQSEAGSHTLQSMYGCDVGPDGRLLRGHNQYAYDGKDYIALNEDLRSWTAADTAAQITQRKWEAARVAEQDRAYLEGTCVEWLRRYLENGKDTLERADPP/AAAKKKYCL	initial_guess_benchmark/alignment/6P2S_0_with_pep.tsv	6P2S_0/6P2S_0	initial_guess_benchmark/pandora/6P2S_0/no_modelling_output_dict.json
SHSMRYFYTAVSRPGRGEPRFIAVGYVDDTQFVQFDSDAASPRGEPRAPWVEQEGPEYWDRETQKYKRQAQTDRVSLRNLRGYYNQSEAGSHTLQRMYGCDLGPDGRLLRGYNQFAYDGKDYIALNEDLRSWTAADKAAQITQRKWEAAREAEQRRAYLEGTCVEWLRRYLENGKKTLQRAEHPK/GADGVGKSA	initial_guess_benchmark/alignment/6ULI_0_with_pep.tsv	6ULI_0/6ULI_0	initial_guess_benchmark/pandora/6ULI_0/no_modelling_output_dict.json
GSHSMRYFFTSVSRPGRGEPRFIAVGYVDDTQFVRFDSDAASQRMEPRAPWIEQEGPEYWDGETRKVKAHSQTHRVDLGTLRGYYNQSEAGSHTVQRMYGCDVGSDWRFLRGYHQYAYDGKDYIALKEDLRSWTAADMAAQTTKHKWEAAHVAEQLRAYLEGTCVEWLRRYLENGKETLQRTDAP/ALWEIQQVV	initial_guess_benchmark/alignment/7LG2_0_with_pep.tsv	7LG2_0/7LG2_0	initial_guess_benchmark/pandora/7LG2_0/no_modelling_output_dict.json
GSHSMRYFHTAMSRPGRGEPRFITVGYVDDTLFVRFDSDATSPRKEPRAPWIEQEGPEYWDRETQISKTNTQTYRESLRNLRGYYNQSEAGSHTLQRMYGCDVGPDGRLLRGHNQYAYDGKDYIALNEDLRSWTAADTAAQISQRKLEAARVAEQLRAYLEGECVEWLRRYLENGKDKLERADPP/GETALALLLL	initial_guess_benchmark/alignment/6IEX_0_with_pep.tsv	6IEX_0/6IEX_0	initial_guess_benchmark/pandora/6IEX_0/no_modelling_output_dict.json
GSHSMRYFFTSVSRPGRGEPRFIAVGYVDDTQFVRFDSDAASQRMEPRAPWIEQEGPEYWDGETRKVKAHSQTHRVDLGTLRGYYNQSEAGSHTVQRMYGCDVGSDWRFLRGYHQYAYDGKDYIALKEDLRSWTAADMAAQTTKHKWEAAHVAEQLRAYLEGTCVEWLRRYLENGKETLQRTDAP/ELAGIGILTV	initial_guess_benchmark/alignment/6DKP_0_with_pep.tsv	6DKP_0/6DKP_0	initial_guess_benchmark/pandora/6DKP_0/no_modelling_output_dict.json
SHSMRYFYTAVSRPGRGEPRFIAVGYVDDTQFVQFDSDAASPRGEPRAPWVEQEGPEYWDRETQKYKRQAQTDRVSLRNLRGYYNQSEAGSHTLQRMYGCDLGPDGRLLRGYNQFAYDGKDYIALNEDLRSWTAADKAAQITQRKWEAAREAEQRRAYLEGTCVEWLRRYLENGKKTLQRAEHPK/GADGVGKSA	initial_guess_benchmark/alignment/6JTP_0_with_pep.tsv	6JTP_0/6JTP_0	initial_guess_benchmark/pandora/6JTP_0/no_modelling_output_dict.json
GSHSMRYFHTSVSRPGRGEPRFISVGYVDDTQFVRFDSDAASPRTEPRAPWIEQEGPEYWDRETQISKTNTQTYREDLRTLLRYYNQSEAGSHTIQRMSGCDVGPDGRLLRGYNQFAYDGKDYIALNEDLSSWTAADTAAQITQRKWEAARVAEQDRAYLEGTCVEWLRRYLENGKETLQRADPP/FEDLRVLSF	initial_guess_benchmark/alignment/6MTM_0_with_pep.tsv	6MTM_0/6MTM_0	initial_guess_benchmark/pandora/6MTM_0/no_modelling_output_dict.json
GSHSMRYFSTSVSRPGSGEPRFIAVGYVDDTQFVRFDSDAASQRMEPRAPWIEQERPEYWDQETRNVKAQSQTDRVDLGTLRGYYNQSEAGSHTIQIMYGCDVGSDGRFLRGYEQHAYDGKDYIALNEDLRSWTAADMAAQITQRKWEAARWAEQLRAYLEGTCVEWLRRYLENGKETLQRTDPP/AIFQSSMTK	initial_guess_benchmark/alignment/6J1W_0_with_pep.tsv	6J1W_0/6J1W_0	initial_guess_benchmark/pandora/6J1W_0/no_modelling_output_dict.json
AGPHSMRYFETAVSRPGLGEPRYISVGYVDNKEFVRFDSDAENPRYEPQAPWMEQEGPEYWERITQIAKGQEQWFRVNLRTLLGYYNQSAGGTHTLQWMYGCDVGSDGRLLRGYEQFAYDGCDYIALNEDLKTWTAADMAAQITRRKWEQAGAAEYYRAYLEGECVEWLHRYLKNGNATLLRTDS/SPSYVYHQF	initial_guess_benchmark/alignment/6L9M_0_with_pep.tsv	6L9M_0/6L9M_0	initial_guess_benchmark/pandora/6L9M_0/no_modelling_output_dict.json
GSHSMRYFFTSVSRPGRGEPRFIAVGYVDDTQFVRFDSDAASQRMEPRAPWIEQEGPEYWDGETRKVKAHSQTHRVDLGTLRGYYNQSEAGSHTVQRMYGCDVGSDWRFLRGYHQYAYDGKDYIALKEDLRSWTAADMAAQTTKHKWEAAHVAEQLRAYLEGTCVEWLRRYLENGKETLQRTDAP/IMDQVPFSV	initial_guess_benchmark/alignment/6VM9_0_with_pep.tsv	6VM9_0/6VM9_0	initial_guess_benchmark/pandora/6VM9_0/no_modelling_output_dict.json
GSHSMRYFYTAMSRPGRGEPRFIAVGYVDDTQFVRFDSDAASPRMAPRAPWIEQEGPEYWDGETRNMKASAQTYRENLRIALRYYNQSEAGSHIIQVMYGCDVGPDGRLLRGHDQSAYDGKDYIALNEDLSSWTAADTAAQITQRKWEAARVAEQLRAYLEGLCVEWLRRYLENGKETLQRADPP/LTVQVARVY	initial_guess_benchmark/alignment/5VUF_0_with_pep.tsv	5VUF_0/5VUF_0	initial_guess_benchmark/pandora/5VUF_0/no_modelling_output_dict.json
GSHSMRYFYTAMSRPGRGEPRFIAVGYVDDTQFVRFDSDAASPRTEPRAPWIEQEGPEYWDGETRNMKASAQTYRENLRIALRYYNQSEAGSHIIQRMYGCDLGPDGRLLRGHDQSAYDGKDYIALNEDLSSWTAADTAAQITQRKWEAARVAEQLRAYLEGLCVEWLRRYLENGKETLQRADPP/LTVQVARVW	initial_guess_benchmark/alignment/5VWJ_0_with_pep.tsv	5VWJ_0/5VWJ_0	initial_guess_benchmark/pandora/5VWJ_0/no_modelling_output_dict.json
GSHSMRYFFTSVSRPGRGEPRFIAVGYVDDTQFVRFDSDAASQRMEPRAPWIEQEGPEYWDGETRKVKAHSQTHRVDLGTLRGYYNQSEAGSHTVQRMYGCDVGSDWRFLRGYHQYAYDGKDYIALKEDLRSWTAADMAAQTTKHKWEAAHVAEQLRAYLEGTCVEWLRRYLENGKETLQRTDAP/ELAGIGILTV	initial_guess_benchmark/alignment/5NHT_0_with_pep.tsv	5NHT_0/5NHT_0	initial_guess_benchmark/pandora/5NHT_0/no_modelling_output_dict.json
SHSMRYFDTAVSRPGRGEPRFISVGYVDDTQFVRFDSDAASPRGEPRAPWVEQEGPEYWDRETQKYKRQAQADRVSLRNLRGYYNQSEDGSHTLQRMSGCDLGPDGRLLRGYDQSAYDGKDYIALNEDLRSWTAADTAAQITQRKLEAARAAEQLRAYLEGTCVEWLRRYLENGKETLQRAEPPK/RYRPGTVAL	initial_guess_benchmark/alignment/6PA1_0_with_pep.tsv	6PA1_0/6PA1_0	initial_guess_benchmark/pandora/6PA1_0/no_modelling_output_dict.json
GPHSMRYFETAVSRPGLEEPRYISVGYVDNKEFVRFDSDAENPRYEPRAPWMEQEGPEYWERETQKAKGQEQWFRVSLRNLLGYYNQSAGGSHTLQQMSGCDLGSDWRLLRGYLQFAYEGRDYIALNEDLKTWTAADMAAQITRRKWEQSGAAEHYKAYLEGECVEWLHRYLKNGNATLLRTDSP/KAPYDYAPI	initial_guess_benchmark/alignment/6G9Q_0_with_pep.tsv	6G9Q_0/6G9Q_0	initial_guess_benchmark/pandora/6G9Q_0/no_modelling_output_dict.json
GSHSMRYFYTSVSRPGRGEPRFISVGYVDDTQFVRFDSDAASPREEPRAPWIEQEGPEYWDRNTQIYKAQAQTDRESLRNLRGYYNQSEAGSHTLQSMYGCDVGPDGRLLRGHDQYAYDGKDYIALNEDLRSWTAADTAAQITQRKWEAAREAEQRRAYLEGECVEWLRRYLENGKDKLERADPP/SPRWYFYYL	initial_guess_benchmark/alignment/7LGD_0_with_pep.tsv	7LGD_0/7LGD_0	initial_guess_benchmark/pandora/7LGD_0/no_modelling_output_dict.json
GSHSMRYFFTSVSRPGRGEPRFIAVGYVDDTQFVRFDSDAASQRMEPRAPWIEQEGPEYWDGETRKVKAHSQTHRVDLGTLRGYYNQSEAGSHTVQRMYGCDVGSDWRFLRGYHQYAYDGKDYIALKEDLRSWTAADMAAQTTKHKWEAAHVAEQLRAYLEGTCVEWLRRYLENGKETLQRTDAP/KLVALGINAV	initial_guess_benchmark/alignment/5YXU_0_with_pep.tsv	5YXU_0/5YXU_0	initial_guess_benchmark/pandora/5YXU_0/no_modelling_output_dict.json
ELHTLRYIRTAMTDPGPGQPWFVTVGYVDGELFVHYNSTARRYVPRTEWIAANTDQQYWDGQTQIGQLNEQINRENLGIRQRRYNQTGGSHTVQWMFGCDILEDGTIRGYRQSAYDGRDFIALDKDMKTFTAAVPEAVPTKRKWEEESEPERWKNYLEETCVEWLRRYVEYGKAELGRRERPEVR/IDWFDGKE	initial_guess_benchmark/alignment/6LHG_0_with_pep.tsv	6LHG_0/6LHG_0	initial_guess_benchmark/pandora/6LHG_0/no_modelling_output_dict.json
GSHSMRYFYTSVSRPGRGEPRFISVGYVDDTQFVRFDSDAASPREEPRAPWIEQEGPEYWDRNTQIYKAQAQTDRESLRNLRGYYNQSEAGSHTLQSMYGCDVGPDGRLLRGHDQYAYDGKDYIALNEDLRSWTAADTAAQITQRKWEAAREAEQRRAYLEGECVEWLRRYLENGKDKLERADPP/SPRWYFYYL	initial_guess_benchmark/alignment/7LG0_0_with_pep.tsv	7LG0_0/7LG0_0	initial_guess_benchmark/pandora/7LG0_0/no_modelling_output_dict.json
GSHSMRYFFTSVSRPGRGEPRFIAVGYVDDTQFVRFDSDAASQRMEPRAPWIEQEGPEYWDGETRKVKAHSQTHRVDLGTLRGYYNQSEAGSHTVQRMYGCDVGSDWRFLRGYHQYAYDGKDYIALKEDLRSWTAADMAAQTTKHKWEAAHVAEQLRAYLEGTCVEWLRRYLENGKETLQRTDAP/KLNDLCFTNV	initial_guess_benchmark/alignment/7M8S_0_with_pep.tsv	7M8S_0/7M8S_0	initial_guess_benchmark/pandora/7M8S_0/no_modelling_output_dict.json
GSHSMRYFHTSVSRPGRGEPRFITVGYVDDTLFVRFDSDAASPREEPRAPWIEQEGPEYWDRETQICKAKAQTDREDLRTLLRYYNQSEAGSHTLQNMYGCDVGPDGRLLRGYHQDAYDGKDYIALNEDLSSWTAADTAAQITQRKWEAARVAEQLRAYLEGECVEWLRRYLENGKETLQRADPP/GRLNEPIKV	initial_guess_benchmark/alignment/6Y28_0_with_pep.tsv	6Y28_0/6Y28_0	initial_guess_benchmark/pandora/6Y28_0/no_modelling_output_dict.json
SHSMRYFFTSVSRPGRGEPRFIAVGYVDDTQFVRFDSDAASQRMEPRAPWIEQEGPEYWDGETRKVKAHSQTHRVDLGTLRGYYNQSEAGSHTVQRMYGCDVGSDWRFLRGYHQYAYDGKDYIALKEDLRSWTAADMAAQTTKHKWEAAHVAEQLRAYLEGTCVEWLRRYLENGKETLQRTDAPK/GVYDGREHTV	initial_guess_benchmark/alignment/6TRO_0_with_pep.tsv	6TRO_0/6TRO_0	initial_guess_benchmark/pandora/6TRO_0/no_modelling_output_dict.json
MGPHSMRYFETAVSRPGLEEPRYISVGYVDNKEFVRFDSDAENPRYEPRAPWMEQEGPEYWERETQKAKGQEQWFRVSLRNLLGYYNQSAGGSHTLQQMSGCDLGSDWRLLRGYLQFAYEGRDYIALNEDLKTWTAADMAAQITRRKWEQSGAAEHYKAYLEGECVEWLHRYLKNGNATLLRTDS/SGPDNGAVAV	initial_guess_benchmark/alignment/6WZY_0_with_pep.tsv	6WZY_0/6WZY_0	initial_guess_benchmark/pandora/6WZY_0/no_modelling_output_dict.json
SHSMRYFSAAVSRPGRGEPRFIAMGYVDDTQFVRFDSDSASPRMEPRAPWVEQEGPEYWEEETRNTKAHAQTDRMNLQTLRGYYNQSEASSHTLQWMIGCDLLLRGYEQYAYDGKDYLALNEDLRSWTAADTAAQISKRKCEAANVAEQRRAYLEGTCVEWLHRYLENGKEMLQRADPPKTHVTH/RIIPRHLQL	initial_guess_benchmark/alignment/6K60_0_with_pep.tsv	6K60_0/6K60_0	initial_guess_benchmark/pandora/6K60_0/no_modelling_output_dict.json
GPHSMRYFETAVSRPGLEEPRYISVGYVDNKEFVRFDSDAENPRYEPRAPWMEQEGPEYWERETQKAKGQEQWFRVSLRNLLGYYNQSAGGSHTLQQMSGCDLGSDWRLLRGYQQYAYDGRDYIALNEDLKTWTAADMAAQITRRKWEQSGAAEHYKAYLEGECVEWLHRYLKNGNRTDSPKAHV/SGPSNTPPEI	initial_guess_benchmark/alignment/6H6H_0_with_pep.tsv	6H6H_0/6H6H_0	initial_guess_benchmark/pandora/6H6H_0/no_modelling_output_dict.json
SHSMRYFFTSVSRPGRGEPRFIAVGYVDDTQFVRFDSDAASQRMEPRAPWIEQEGPEYWDGETRKVKAHSQTHRVDLGTLRGYYNQSEAGSHTVQRMYGCDVGSDWRFLRGYHQYAYDGKDYIALKEDLRSWTAADMAAQTTKHKWEAAHVAEQLRAYLEGTCVEWLRRYLENGKETLQRTDAPK/MMWDRGLGMM	initial_guess_benchmark/alignment/6AMU_0_with_pep.tsv	6AMU_0/6AMU_0	initial_guess_benchmark/pandora/6AMU_0/no_modelling_output_dict.json
GSHSMRYFFTSVSRPGRGEPRFIAVGYVDDTQFVRFDSDAASQRMEPRAPWIEQEGPEYWDGETRKVKAHSQTHRVDLGTLRGYYNQSEAGSHTVQRMYGCDVGSDWRFLRGYHQYAYDGKDYIALKEDLRSWTAADMAAQTTKHKWEAAHVAEQLRAYLEGTCVEWLRRYLENGKETLQRTDAP/LLWNGPMQV	initial_guess_benchmark/alignment/6SSA_0_with_pep.tsv	6SSA_0/6SSA_0	initial_guess_benchmark/pandora/6SSA_0/no_modelling_output_dict.json
GSHSMRYFYTSVSRPGRGEPRFISVGYVDDTQFVRFDSDAASPREEPRAPWIEQEGPEYWDRNTQIYKAQAQTDRESLRNLRGYYNQSEAGSHTLQSMYGCDVGPDGRLLRGHDQYAYDGKDYIALNEDLRSWTAADTAAQITQRKWEAAREAEQRRAYLEGECVEWLRRYLENGKDKLERADPP/SPIVPSFDM	initial_guess_benchmark/alignment/5WMN_0_with_pep.tsv	5WMN_0/5WMN_0	initial_guess_benchmark/pandora/5WMN_0/no_modelling_output_dict.json
SHSMRYFSAAVSRPGRGEPRFIAMGYVDDTQFVRFDSDSASPRMEPRAPWVEQEGPEYWEEETRNTKAHAQTDRMNLQTLRGYYNQSEASSHTLQWMIGCDLGSDGRLIRGYERYAYDGKDYLALNEDLRSWTAADTAAQISKRKCEAANVAEQRRAYLEGTCVEWLHRYLENGKEMLQRADPPK/RIIPRHLQL	initial_guess_benchmark/alignment/6AEE_0_with_pep.tsv	6AEE_0/6AEE_0	initial_guess_benchmark/pandora/6AEE_0/no_modelling_output_dict.json
GPHSLSYFYTAVSRPDRGDSRFIAVGYVDDTQFVRFDNYAPNPRMEPRVPWIQQEGQDYWDEETRKVKDNAQTYGVGLNTLRGYYNQSEAGSHTLQSMYGCYLGPDGLLLHGYRQDAYDGADYIALNEDLRSWTAADMAAQITKRKWEAANVAERRRSYLQGLCVESLRRYLEMGKDTLQRAEPP/NSDTVGWSW	initial_guess_benchmark/alignment/6KWN_0_with_pep.tsv	6KWN_0/6KWN_0	initial_guess_benchmark/pandora/6KWN_0/no_modelling_output_dict.json
GSHSMRYFFTSVSRPGRGEPRFIAVGYVDDTQFVRFDSDAASQRMEPRAPWIEQEGPEYWDGETRKVKAHSQTHRVDLGTLRGYYNQSEAGSHTVQRMYGCDVGSDWRFLRGYHQYAYDGKDYIALKEDLRSWTAADMAAQTTKHKWEAAHVAEQLRAYLEGTCVEWLRRYLENGKETLQRTDAP/AAGIGILTV	initial_guess_benchmark/alignment/6EQB_0_with_pep.tsv	6EQB_0/6EQB_0	initial_guess_benchmark/pandora/6EQB_0/no_modelling_output_dict.json
SHSMRYFFTSVSRPGRGEPRFIAVGYVDDTQFVRFDSDAASQRMEPRAPWIEQEGPEYWDGETRKVKAHSQTHRVDLGTLRGYYNQSEAGSHTVQRMYGCDVGSDWRFLRGYHQYAYDGKDYIALKEDLRSWTAADMAAQTTKHKWEAAHVAEQLRAYLEGTCVEWLRRYLENGKETLQRTDAPK/KLVVVGAVGV	initial_guess_benchmark/alignment/6O53_0_with_pep.tsv	6O53_0/6O53_0	initial_guess_benchmark/pandora/6O53_0/no_modelling_output_dict.json
GSHSMRYFHTSVSRPGRGEPRFITVGYVDDTLFVRFDSDAASPREEGRAPWIEQEGPEHWDRETQICKAKAQTDREDLRTLLRYYNQSEAGSHTLQNMYGCDVGPDGRLLRGYHQDAYDGKDYIALNEDLSSWTAADTAAQITQRKWEAARVAEQLRAYLEGECVEWLRRYLENGKETLQRADPP/LRNQSVFNF	initial_guess_benchmark/alignment/6PYV_0_with_pep.tsv	6PYV_0/6PYV_0	initial_guess_benchmark/pandora/6PYV_0/no_modelling_output_dict.json
GSHSMRYFFTSVSRPGRGEPRFIAVGYVDDTQFVRFDSDAASQKMEPRAPWIEQEGPEYWDQETRNMKAHSQTDRANLGTLRGYYNQSEDGSHTIQIMYGCDVGPDGRFLRGYRQDAYDGKDYIALNEDLRSWTAADMAAQITKRKWEAVHAAEQRRVYLEGRCVDGLRRYLENGKETLQRTDPP/ILDTAGKEEY	initial_guess_benchmark/alignment/6MPP_0_with_pep.tsv	6MPP_0/6MPP_0	initial_guess_benchmark/pandora/6MPP_0/no_modelling_output_dict.json
GSHSMRYFYTSVSRPGRGEPRFISVGYVDDTQFVRFDSDAASPREEPRAPWIEQEGPEYWDRNTQIYKAQAQTDRESLRNLRGYYNQSEAGSHTLQSMYGCDVGPDGRLLRGHDQYAYDGKDYIALNEDLRSWTAADTAAQITQRKWEAAREAEQRRAYLEGECVEWLRRYLENGKDKLERADPP/TPRVTGGGAM	initial_guess_benchmark/alignment/5WMP_0_with_pep.tsv	5WMP_0/5WMP_0	initial_guess_benchmark/pandora/5WMP_0/no_modelling_output_dict.json
GSHSMRYFYTAMSRPGRGEPRFIAVGYVDDTQFVRFDSDAASPRMAPRAPWIEQEGPEYWDGETRNMKASAQTYRENLRIALRYYNQSEAGSHIIQVMYGCDVGPDGRLLRGHNQYAYDGKDYIALNEDLSSWTAADTAAQITQRKWEAARVAEQLRAYLEGLCVEWLRRYLENGKETLQRADPP/LSSPVTKSW	initial_guess_benchmark/alignment/5VVP_0_with_pep.tsv	5VVP_0/5VVP_0	initial_guess_benchmark/pandora/5VVP_0/no_modelling_output_dict.json
GSHSMRYFYTSVSRPGRGEPRFISVGYVDDTQFVRFDSDAASPREEPRAPWIEQEGPEYWDRNTQIYKAQAQTDRESLRNLRGYYNQSEAGSHTLQSMYGCDVGPDGRLLRGHDQYAYDGKDYIALNEDLRSWTAADTAAQITQRKWEAAREAEQRRAYLEGECVEWLRRYLENGKDKLERADPP/RPPIFIRRL	initial_guess_benchmark/alignment/5WMO_0_with_pep.tsv	5WMO_0/5WMO_0	initial_guess_benchmark/pandora/5WMO_0/no_modelling_output_dict.json
GSHSMRYFDTAMSRPGRGEPRFISVGYVDDTQFVRFDSDAASPREEPRAPWIEQEGPEYWDRNTQIFKTNTQTDRCSLRNLRGYYNQSEAGSHTLQSMYGCDVGPDGRLLRGHNQYAYDGKDYIALNEDLRSWTAADTAAQITQRKWEAARVAEQDRAYLEGTCVEWLRRYLENGKDTLERADPP/AAAKKKYCL	initial_guess_benchmark/alignment/6P23_0_with_pep.tsv	6P23_0/6P23_0	initial_guess_benchmark/pandora/6P23_0/no_modelling_output_dict.json
GSHSLKYFHTSVSRPGRGEPRFISVGYVDDTQFVRFDNDAASPRMVPRAPWMEQEGSEYWDRETRSARDTAQIFRVNLRTLRGYYNQSEAGSHTLQWMHGCELGPDGRFLRGYEQFAYDGKDYLTLNEDLRSWTAVDTAAQISEQKSNDASEAEHQRAYLEDTCVEWLHKYLEKGKETLLHLEPP/RLPAKAPLL	initial_guess_benchmark/alignment/6GH1_0_with_pep.tsv	6GH1_0/6GH1_0	initial_guess_benchmark/pandora/6GH1_0/no_modelling_output_dict.json
MELHTLRYIQTAMTDPGPGQPWFVTVGYVDGELFVHYNSTARRYVPRTEWIAAKADQQYWDGQTQIGQGNEQIDRENLGILQRRYNQTGGSHTVQWMYGCDILEGGPIRGYYQMAYDGRDFTAFDKGTMTFTAAVPEAVPTKRKWEEESEPERWKNYLEETCVEWLRRYVEYGKAELGRRERPEV/LPACVLEV	initial_guess_benchmark/alignment/5YMW_0_with_pep.tsv	5YMW_0/5YMW_0	initial_guess_benchmark/pandora/5YMW_0/no_modelling_output_dict.json
GSHSMRYFFTSVSRPGRGEPRFIAVGYVDDTQFVRFDSDAASQRMEPRAPWIEQEGPEYWDGETRKVKAHSQTHRVDLGTLRGYYNQSEAGSHTVQRMYGCDVGSDWRFLRGYHQYAYDGKDYIALKEDLRSWTAADMAAQTTKHKWEAAHVAEQLRAYLEGTCVEWLRRYLENGKETLQRTDAP/RLSSPLHFV	initial_guess_benchmark/alignment/6EWC_0_with_pep.tsv	6EWC_0/6EWC_0	initial_guess_benchmark/pandora/6EWC_0/no_modelling_output_dict.json
GSHSMRYFFTSVSRPGRGEPRFIAVGYVDDTQFVRFDSDAASQRMEPRAPWIEQEGPEYWDGETRKVKAHSQTHRVDLGTLRGYYNQSEAGSHTVQRMYGCDVGSDWRFLRGYHQYAYDGKDYIALKEDLRSWTAADMAAQTTKHKWEAAHVAEQLRAYLEGTCVEWLRRYLENGKETLQRTDAP/KLVVGAVGV	initial_guess_benchmark/alignment/6O4Y_0_with_pep.tsv	6O4Y_0/6O4Y_0	initial_guess_benchmark/pandora/6O4Y_0/no_modelling_output_dict.json
GSHSLKYFHTSVSRPGRGEPRFISVGYVDDTQFVRFDNDAASPRMVPRAPWMEQEGSEYWDRETRSARDTAQIFRVNLRTLRGYYNQSEAGSHTLQWMHGCELGPDGRFLRGYEQFAYDGKDYLTLNEDLRSWTAVDTAAQISEQKSNDASEAEHQRAYLEDTCVEWLHKYLEKGKETLLHLEPP/RMYSPTSIL	initial_guess_benchmark/alignment/6GL1_0_with_pep.tsv	6GL1_0/6GL1_0	initial_guess_benchmark/pandora/6GL1_0/no_modelling_output_dict.json
GSHSMRYFFTSVSRPGRGEPRFIAVGYVDDTQFVRFDSDAASQRMEPRAPWIEQEGPEYWDGETRKVKAHSQTHRVDLGTLRGYYNQSEAGSHTVQRMYGCDVGSDWRFLRGYHQYAYDGKDYIALKEDLRSWTAADMAAQTTKHKWEAAHVAEQLRAYLEGTCVEWLRRYLENGKETLQRTDAP/LLLPRLPPL	initial_guess_benchmark/alignment/7MJ9_0_with_pep.tsv	7MJ9_0/7MJ9_0	initial_guess_benchmark/pandora/7MJ9_0/no_modelling_output_dict.json
GSHSMRYFYTSVSRPGRGEPRFIAVGYVDDTQFVRFDSDAASQRMEPRAPWIEQEGPEYWDGETRKVKAHSQTHRVDLGTLRGYYNQSEAGSHTVQRMYGCDVGSDWRFLRGYHQYAYDGKDYIALKEDLRSWTAADMAAQTTKHKWEAAHVAEQLRAYLEGTCVEWLRRYLENGKETLQRTDAP/KQWLVWLLL	initial_guess_benchmark/alignment/6UK2_0_with_pep.tsv	6UK2_0/6UK2_0	initial_guess_benchmark/pandora/6UK2_0/no_modelling_output_dict.json
GSHSLKYFHTSVSRPGRGEPRFISVGYVDDTQFVRFDNDAASPRMVPRAPWMEQEGSEYWDRETRSARDTAQIFRVNLRTLRGYYNQSEAGSHTLQWMHGCELGPDGRFLRGYEQFAYDGKDYLTLNEDLRSWTAVDTAAQISEQKSNDASEAEHQRAYLEDTCVEWLHKYLEKGKETLLHLEPP/RFPAKAPLL	initial_guess_benchmark/alignment/6GGM_0_with_pep.tsv	6GGM_0/6GGM_0	initial_guess_benchmark/pandora/6GGM_0/no_modelling_output_dict.json
GPHSLSYFSTAVSRPDRGDSRFIAVGYVDDTQFVRFDSDAPNPRMEPRVPWIQQEGQEYWAEETRKVKDNAQTYRVNLKALRGYYNQSVAGSHTLQSMFGCYLGPDGLLLHGYRQDAYDGADYIALNEDLRSWTAADMAAQITKRKWEAADAAEQMRSYLQGLCVESLRKYLEMGKDTLQRAEPP/TMPPGFELY	initial_guess_benchmark/alignment/5YLX_0_with_pep.tsv	5YLX_0/5YLX_0	initial_guess_benchmark/pandora/5YLX_0/no_modelling_output_dict.json
GSHSMRYFFTSVSRPGRGEPRFIAVGYVDDTQFVRFDSDAASQRMEPRAPWIEQEGPEYWDGETRKVKAHSQTHRVDLGTLRGYYNQSEAGSHTVQRMYGCDVGSDWRFLRGYHQYAYDGKDYIALKEDLRSWTAADMAAQTTKHKWEAAHVAEQLRAYLEGTCVEWLRRYLENGKETLQRTDAP/HMTEVVRRC	initial_guess_benchmark/alignment/6VR1_0_with_pep.tsv	6VR1_0/6VR1_0	initial_guess_benchmark/pandora/6VR1_0/no_modelling_output_dict.json
MGPHSMRYFETAVSRPGLEEPRYISVGYVDNKEFVRFDSDAENPRYEPRAPWMEQEGPEYWERETQKAKGQEQWFRVSLRNLLGYYNQSAGGSHTLQQMSGCDLGSDWRLLRGYLQFAYEGRDYIALNEDLKTWTAADMAAQITRRKWEQSGAAEHYKAYLEGECVEWLHRYLKNGNATLLRTDS/SGPDNGAVAVL	initial_guess_benchmark/alignment/6X00_0_with_pep.tsv	6X00_0/6X00_0	initial_guess_benchmark/pandora/6X00_0/no_modelling_output_dict.json
GSHSMRYFYTAMSRPGRGEPRFIAVGYVDDTQFVRFDSDAASPRMAPRAPWIEQEGPEYWDGETRNMKASAQTYRENLRIALRYYNQSEAGSHIIQVMYGCDVGPDGRLLRGHNQYAYDGKDYIALNEDLSSWTAADTAAQITQRKWEAARVAEQLRAYLEGLCVEWLRRYLENGKETLQRADPP/LTVQVARVY	initial_guess_benchmark/alignment/5VWF_0_with_pep.tsv	5VWF_0/5VWF_0	initial_guess_benchmark/pandora/5VWF_0/no_modelling_output_dict.json
GSHSMRYFFTSVSRPGRGEPRFIAVGYVDDTQFVRFDSDAASQRMEPRAPWIEQEGPEYWDGETRKVKAHSQTHRVDLGTLRGYYNQSEAGSHTVQRMYGCDVGSDWRFLRGYHQYAYDGKDYIALKEDLRSWTAADMAAQTTKHKWEAAHVAEQLRAYLEGTCVEWLRRYLENGKETLQRTDAP/HMTEVVRHC	initial_guess_benchmark/alignment/6W51_0_with_pep.tsv	6W51_0/6W51_0	initial_guess_benchmark/pandora/6W51_0/no_modelling_output_dict.json
GSHSMRYFFTSVSRPGRGEPRFIAVGYVDDTQFVRFDSDAASQRMEPRAPWIEQEGPEYWDGETRKVKAHSQTHRVDLGTLRGYYNQSEAGSHTVQRMYGCDVGSDWRFLRGYHQYAYDGKDYIALKEDLRSWTAADMAAQTTKHKWEAAHVAEQLRAYLEGTCVEWLRRYLENGKETLQRTDAP/SLLMWITQV	initial_guess_benchmark/alignment/6RPA_0_with_pep.tsv	6RPA_0/6RPA_0	initial_guess_benchmark/pandora/6RPA_0/no_modelling_output_dict.json
GSHSMRYFFTSVSRPGRGEPRFIAVGYVDDTQFVRFDSDAASQRMEPRAPWIEQEGPEYWDGETRKVKAHSQTHRVDLGTLRGYYNQSEAGSHTVQRMYGCDVGSDWRFLRGYHQYAYDGKDYIALKEDLRSWTAADMAAQTTKHKWEAAHVAEQLRAYLEGTCVEWLRRYLENGKETLQRTDAP/YVLDHLIVV	initial_guess_benchmark/alignment/6NCA_0_with_pep.tsv	6NCA_0/6NCA_0	initial_guess_benchmark/pandora/6NCA_0/no_modelling_output_dict.json
GSHSMRYFFTSVSRPGRGEPRFIAVGYVDDTQFVRFDSDAASQRMEPRAPWIEQEGPEYWDGETRKVKAHSQTHRVDLGTLRGYYNQSEAGSHTVQRMYGCDVGSDWRFLRGYHQYAYDGKDYIALKEDLRSWTAADMAAQTTKHKWEAAHVAEQLRAYLEGTCVEWLRRYLENGKETLQRTDAP/RTFSPTYGL	initial_guess_benchmark/alignment/6EWO_0_with_pep.tsv	6EWO_0/6EWO_0	initial_guess_benchmark/pandora/6EWO_0/no_modelling_output_dict.json
GSHSLKYFHTSVSRPGRGEPRFISVGYVDDTQFVRFDNDAASPRMVPRAPWMEQEGSEYWDRETRSARDTAQIFRVNLRTLRGYYNQSEAGSHTLQWMHGCELGPDGRFLRGYEQFAYDGKDYLTLNEDLRSWTAVDTAAQISEQKSNDASEAEHQRAYLEDTCVEWLHKYLEKGKETLLHLEPP/RQPAKAPLL	initial_guess_benchmark/alignment/6GH4_0_with_pep.tsv	6GH4_0/6GH4_0	initial_guess_benchmark/pandora/6GH4_0/no_modelling_output_dict.json
GSHSMRYFFTSVSRPGRGEPRFIAVGYVDDTQFVRFDSDAASQRMEPRAPWIEQEGPEYWDGETRKVKAHSQTHRVDLGTLRGYYNQSEAGSHTVQRMYGCDVGSDWRFLRGYHQYAYDGKDYIALKEDLRSWTAADMAAQTTKHKWEAAHVAEQLRAYLEGTCVEWLRRYLENGKETLQRTDAP/KLWAQCVQL	initial_guess_benchmark/alignment/7LG3_0_with_pep.tsv	7LG3_0/7LG3_0	initial_guess_benchmark/pandora/7LG3_0/no_modelling_output_dict.json
GSHSMRYFHTSVSRPGRGEPRFITVGYVDDTLFVRFDSDAASPREEPRAPWIEQEGPEYADRETQICKAKAQTDREDLRTLLRYYNQSEAGSHTLQNMYGCDVGPDGRLLRGYHQDAYDGKDYIALNEDLSSWTAADTAAQITQRKWEAARVAEQLRAYLEGECVEWLRRYLENGKETLQRADPP/LRNQSVFNF	initial_guess_benchmark/alignment/6PYW_0_with_pep.tsv	6PYW_0/6PYW_0	initial_guess_benchmark/pandora/6PYW_0/no_modelling_output_dict.json
GSHSMRYFYTAMSRPGRGEPRFIAVGYVDDTQFVRFDSDAASPRMAPRAPWIEQEGPEYWDGETRNMKASAQTYRENLRIALRYYNQSEAGSHIIQVMYGCDVGPDGRLLRGHDQSAYDGKDYIALNEDLSSWTAADTAAQITQRKWEAARVAEQLRAYLEGLCVEWLRRYLENGKETLQRADPP/LALLTGVRW	initial_guess_benchmark/alignment/6D2T_0_with_pep.tsv	6D2T_0/6D2T_0	initial_guess_benchmark/pandora/6D2T_0/no_modelling_output_dict.json
GSHSMRYFFTSVSRPGRGEPRFIAVGYVDDTQFVRFDSDAASQRMEPRAPWIEQEGPEYWDGETRKVKAHSQTHRVDLGTLRGYYNQSEAGSHTVQRMYGCDVGSDWRFLRGYHQYAYDGKDYIALKEDLRSWTAADMAAQTTKHKWEAAHVAEQLRAYLEGTCVEWLRRYLENGKETLQRTDAP/MMWDRGLGMM	initial_guess_benchmark/alignment/6AMT_0_with_pep.tsv	6AMT_0/6AMT_0	initial_guess_benchmark/pandora/6AMT_0/no_modelling_output_dict.json
PHSLSYFYTAVSRPDRGDSRFIAVGYVDDTQFVRFDNYAPNPRMEPRVPWIQQEGQDYWDEETRKVKDNAQTYGVGLNTLRGYYNQSEAGSHTLQSMFGCYLGPDGLLLHGYRQDAYDGADYIALNEDLRSWTAADMAAQITKRKWEAANVAERRRSYLQGLCVESLRRYLEMGKDTLQRAEPPK/ESDTVGWSW	initial_guess_benchmark/alignment/6KWO_0_with_pep.tsv	6KWO_0/6KWO_0	initial_guess_benchmark/pandora/6KWO_0/no_modelling_output_dict.json
GSHSMRYFFTSVSRPGRGEPRFIAVGYVDDTQFVRFDSDAASQRMEPRAPWIEQEGPEYWDGETRKVKAHSQTHRVDLGTLRGYYNQSEAGSHTVQRMYGCDVGSDWRFLRGYHQYAYDGKDYIALKEDLRSWTAADMAAQTTKHKWEAAHVAEQLRAYLEGTCVEWLRRYLENGKETLQRTDAP/EAAGIGILTV	initial_guess_benchmark/alignment/6TMO_0_with_pep.tsv	6TMO_0/6TMO_0	initial_guess_benchmark/pandora/6TMO_0/no_modelling_output_dict.json
GSHSMRYFFTSVSRPGRGEPRFIAVGYVDDTQFVRFDSDAASQRMEPRAPWIEQEGPEYWDGETRKVKAHSQTHRVDLGTLRGYYNQSEAGSHTVQRMYGCDVGSDWRFLRGYHQYAYDGKDYIALKEDLRSWTAADMAAQTTKHKWEAAHVAEQLRAYLEGTCVEWLRRYLENGKETLQRTDAP/IIGWMWIPV	initial_guess_benchmark/alignment/6Z9V_0_with_pep.tsv	6Z9V_0/6Z9V_0	initial_guess_benchmark/pandora/6Z9V_0/no_modelling_output_dict.json
GSHSMRYFYTAMSRPGRGEPRFITVGYVDDTLFVRFDSDATSPRKEPRAPWIEQEGPEYWDRETQISKTNTQTYRENLRTALRYYNQSEAGSHIIQRMYGCDVGPDGRLLRGYDQYAYDGKDYIALNEDLSSWTAADTAAQITQRKWEAARVAEQDRAYLEGLCVESLRRYLENGKETLQRADPP/FEDLRVLSF	initial_guess_benchmark/alignment/6MTL_0_with_pep.tsv	6MTL_0/6MTL_0	initial_guess_benchmark/pandora/6MTL_0/no_modelling_output_dict.json
MELHTLRYIQTAMTDPGPGQPWFVTVGYVDGELFVHYNSTARRYVPRTEWIAAKADQQYWDGQTQIGQGNEQIDRENLGILQRRYNQTGGSHTVQWMYGCDILEGGPIRGYYQMAYDGRDFTAFDKGTMTFTAAVPEAVPTKRKWEEESEPERWKNYLEETCVEWLRRYVEYGKAELGRRERPEV/AVKGVGTMV	initial_guess_benchmark/alignment/5YMV_0_with_pep.tsv	5YMV_0/5YMV_0	initial_guess_benchmark/pandora/5YMV_0/no_modelling_output_dict.json
GSHSMRYFSTSVSRPGRGEPRFIAVGYVDDTQFVRFDSDAASQRMEPRAPWIEQEGPEYWDEETGKVKAHSQTDRENLRIALRYYNQSEAGSHTLQMMFGCDVGSDGRFLRGYHQYAYDGKDYIALKEDLRSWTAADMAAQITKRKWEAAHVAEQQRAYLEGTCVDGLRRYLENGKETLQRTDPP/RYPLTFGW	initial_guess_benchmark/alignment/7K80_0_with_pep.tsv	7K80_0/7K80_0	initial_guess_benchmark/pandora/7K80_0/no_modelling_output_dict.json
GSHSMRYFFTSVSRPGRGEPRFIAVGYVDDTQFVRFDSDAASQRMEPRAPWIEQEGPEYWDGETRKVKAHSQTHRVDLGTLRGYYNQSEAGSHTVQRMYGCDVGSDWRFLRGYHQYAYDGKDYIALKEDLRSWTAADMAAQTTKHKWEAAHVAEQLRAYLEGTCVEWLRRYLENGKETLQRTDAP/LLWNGPIAV	initial_guess_benchmark/alignment/6SS8_0_with_pep.tsv	6SS8_0/6SS8_0	initial_guess_benchmark/pandora/6SS8_0/no_modelling_output_dict.json
SHSLRYFVTAVSRPGFGEPRYMEVGYVDNTEFVRFDSDAENPRYEPRARWIEQEGPEYWERETRRAKGNEQSFRVDLRTALRCYNQSAGGSHTLQWMAGCDVESDGRLLRGYWQFAYDGSDYIALNEDLKTWTAADMCAQITRRKWEQAGAAERDRAYLEGECVEWLRRYLKNGNATLLRTDPPK/RGPGRAFVTI	initial_guess_benchmark/alignment/6NPR_0_with_pep.tsv	6NPR_0/6NPR_0	initial_guess_benchmark/pandora/6NPR_0/no_modelling_output_dict.json
GSHSMRYFFTSVSRPGRGEPRFIAVGYVDDTQFVRFDSDAASQRMEPRAPWIEQEGPEYWDGETRKVKAHSQTHRVDLGTLRGYYNQSEAGSHTVQRMYGCDVGSDWRFLRGYHQYAYDGKDYIALKEDLRSWTAADMAAQTTKHKWEAAHVAEQLRAYLEGTCVEWLRRYLENGKETLQRTDAP/ILLNKHIDA	initial_guess_benchmark/alignment/7KGO_0_with_pep.tsv	7KGO_0/7KGO_0	initial_guess_benchmark/pandora/7KGO_0/no_modelling_output_dict.json
GPHSMRYFETAVSRPGLEEPRYISVGYVDNKEFVRFDSDAENPRYEPRAPWMEQEGPEYWERETQKAKGQEQWFRVSLRNLLGYYNQSAGGSHTLQQMSGCDLGSDWRLLRGYLQFAYEGRDYIALNEDLKTWTAADMAAQITRRKWEQSGAAEHYKAYLEGECVEWLHRYLKNGNATLLRTDSP/KAPYDYAPI	initial_guess_benchmark/alignment/6G9R_0_with_pep.tsv	6G9R_0/6G9R_0	initial_guess_benchmark/pandora/6G9R_0/no_modelling_output_dict.json
SHSMRYFYTAVSRPGRGEPRFIAVGYVDDTQFVQFDSDAASPRGEPRAPWVEQEGPEYWDRETQKYKRQAQTDRVNLRKLRGYYNQSEAGSHTLQRMYGCDLGPDGRLLRGYNQFAYDGKDYIALNEDLRSWTAADKAAQITQRKWEAAREAEQRRAYLEGTCVEWLRRYLENGKKTLQRAEHPK/GADGVGKSAL	initial_guess_benchmark/alignment/6JTO_0_with_pep.tsv	6JTO_0/6JTO_0	initial_guess_benchmark/pandora/6JTO_0/no_modelling_output_dict.json
GSHSMRYFHTSVSRPGRGEPRFITVGYVDDTLFVRFDSDAASPREEPRAPWIEQEGPEHWDRETQICKAKAQTDREDLRTLLRYYNQSEAGSHTLQNMYGCDVGPDGRLLRGYHQDAYDGKDYIALNEDLSSWTAADTAAQITQRKWEAARVAEQLRAYLEGECVEWLRRYLENGKETLQRADPP/KRWIILGLNK	initial_guess_benchmark/alignment/6PYL_0_with_pep.tsv	6PYL_0/6PYL_0	initial_guess_benchmark/pandora/6PYL_0/no_modelling_output_dict.json
GSHSMRYFYTAMSRPGRGEPRFIAVGYVDDTQFVRFDSDAASPRMAPRAPWIEQEGPEYWDGETRNMKASAQTYRENLRIALRYYNQSEAGSHIIQVMYGCDVGPDGRLLRGHNQYAYDGKDYIALNEDLSSWTAADTAAQITQRKWEAARVAEQLRAYLEGLCVEWLRRYLENGKETLQRADPP/ASLNLPAVSW	initial_guess_benchmark/alignment/6V2P_0_with_pep.tsv	6V2P_0/6V2P_0	initial_guess_benchmark/pandora/6V2P_0/no_modelling_output_dict.json
SHSMRYFYTAVSRPGRGEPRFIAVGYVDDTQFVQFDSDAASPRGEPRAPWVEQEGPEYWDRETQKYKRQAQTDRVSLRNLRGYYNQSEAGSHTLQRMYGCDLGPDGRLLRGYNQFAYDGKDYIALNEDLRSWTAADKAAQITQRKWEAAREAEQRRAYLEGTCVEWLRRYLENGKKTLQRAEHPK/GADGVGKSAL	initial_guess_benchmark/alignment/6JTN_0_with_pep.tsv	6JTN_0/6JTN_0	initial_guess_benchmark/pandora/6JTN_0/no_modelling_output_dict.json
GSHSMRYFDTAMSRPGRGEPRFISVGYVDDTQFVRFDSDAASPRMEPRAPWIEQEGPEYWDRNTQIFKTNTQTDRESLRNLRGYYNQSEAGSHTLQSMYGCDVGPDGRLLRGHNQYAYDGKDYIALNEDLRSWTAADTAAQITQRKWEAARVAEQDRAYLEGTCVEWLRRYLENGKDTLERADPP/ELRSRYWAI	initial_guess_benchmark/alignment/5WMQ_0_with_pep.tsv	5WMQ_0/5WMQ_0	initial_guess_benchmark/pandora/5WMQ_0/no_modelling_output_dict.json
GSHSMRYFYTAMSRPGRGEPRFIAVGYVDDTQFVRFDSDAASPRMAPRAPWIEQEGPEYWDGETRNMKASAQTYRENLRIALRYYNQSEAGSHIIQVMYGCDVGPDGRLLRGHDQSAYDGKDYIALNEDLSSWTAADTAAQITQRKWEAARVAEQLRAYLEGLCVEWLRRYLENGKETLQRADPP/LTVQVARVW	initial_guess_benchmark/alignment/5VUE_0_with_pep.tsv	5VUE_0/5VUE_0	initial_guess_benchmark/pandora/5VUE_0/no_modelling_output_dict.json
GSHSMRYFFTSVSRPGRGEPRFIAVGYVDDTQFVRFDSDAASQRMEPRAPWIEQEGPEYWDGETRKVKAHSQTHRVDLGTLRGCYNQSEAGSHTVQRMYGCDVGSDWRFLRGYHQYAYDGKDYIALKEDLRSWTAADMCAQTTKHKWEAAHVAEQLRAYLEGTCVEWLRRYLENGKETLQRTDAP/SLLMWITQV	initial_guess_benchmark/alignment/6Q3S_0_with_pep.tsv	6Q3S_0/6Q3S_0	initial_guess_benchmark/pandora/6Q3S_0/no_modelling_output_dict.json
SHSMRYFDTAVSRPGRGEPRFISVGYVDDTQFVRFDSDAASPRGEPRAPWVEQEGPEYWDRETQKYKRQAQADRVSLRNLRGYYNQSEDGSHTLQRMSGCDLGPDGRLLRGYDQSAYDGKDYIALNEDLRSWTAADTAAQITQRKLEAARAAEQLRAYLEGTCVEWLRRYLENGKETLQRAEPPK/RYRPGTVAL	initial_guess_benchmark/alignment/6PAG_0_with_pep.tsv	6PAG_0/6PAG_0	initial_guess_benchmark/pandora/6PAG_0/no_modelling_output_dict.json
ELHTLRYISTAMTDPGPGQPWYVDVGYVDGELFTHYNSTARRAVPRTEWIAANTDQQYWDSETQTSQRTEQIDRDGLGTLQRRYNQTGGSHTVQLMYGCDILEDGTIRGYSQDAYDGRDFIAFDKDTMTFTAAVPEAVPTKRKWEEGDYAEGLKQYLEETCVEWLRRYVEYGKAELGRRERPEVR/RRREQTDY	initial_guess_benchmark/alignment/6LHF_0_with_pep.tsv	6LHF_0/6LHF_0	initial_guess_benchmark/pandora/6LHF_0/no_modelling_output_dict.json
GSHSMRYFHTSVSRPGRGEPRFITVGYVDDTLFVRFDSDAASPREEPRAPWIEQEGPEYWDRETQICKAKAQTDREDLRTLLRYYNQSEAGSHTLQNMYGCDVGPDGRLLRGYHQDAYDGKDYIALNEDLSSWTAADTAAQITQRKWEAARVAEQLRAYLEGECVEWLRRYLENGKETLQRADPP/KRWIILGLNKI	initial_guess_benchmark/alignment/6VPZ_0_with_pep.tsv	6VPZ_0/6VPZ_0	initial_guess_benchmark/pandora/6VPZ_0/no_modelling_output_dict.json
GPHSLRYFVTAVSRPGLGEPRYMEVGYVDDTEFVRFDSDAENPRYEPRARWMEQEGPEYWERETQKAKGNEQSFRVDLRTLLGYYNQSKGGSHTIQVISGCEVGSDGRLLRGYQQYAYDGCDYIALNEDLKTWTAADMAALITKHKWEQAGEAERLRAYLEGTCVEWLRRYLKNGNATLLRTDSP/SIIQFEHL	initial_guess_benchmark/alignment/7JI2_0_with_pep.tsv	7JI2_0/7JI2_0	initial_guess_benchmark/pandora/7JI2_0/no_modelling_output_dict.json
GSHSMRYFFTSVSRPGRGEPRFIAVGYVDDTQFVRFDSDAASQRMEPRAPWIEQEGPEYWDGETRKVKAHSQTHRVDLGTLRGYYNQSEAGSHTVQRMYGCDVGSDWRFLRGYHQYAYDGKDYIALKEDLRSWTAADMAAQTTKHKWEAAHVAEQLRAYLEGTCVEWLRRYLENGKETLQRTDAP/ITSGIGVLPV	initial_guess_benchmark/alignment/6G3K_0_with_pep.tsv	6G3K_0/6G3K_0	initial_guess_benchmark/pandora/6G3K_0/no_modelling_output_dict.json
GSHSMRYFHTSVSRPGRGEPRFITVGYVDDTLFVRFDSDAASPREEPRAPWIEQEGPEYWDRETQICKAKAQTDREDLRTLLRYYNQSEAGSHTLQNMYGCDVGPDGRLLRGYHQHAYDGKDYIALNEDLSSWTAADTAAQITQRKWEAARVAEQLRAYLEGECVEWLRRYLENGKETLQRADPP/GRLNQPIKV	initial_guess_benchmark/alignment/6Y2B_0_with_pep.tsv	6Y2B_0/6Y2B_0	initial_guess_benchmark/pandora/6Y2B_0/no_modelling_output_dict.json
GSHSMRYFFTSVSRPGRGEPRFIAVGYVDDTQFVRFDSDAASQRMEPRAPWIEQEGPEYWDGETRKVKAHSQTHRVDLGTLRGYYNQSEAGSHTVQRMYGCDVGSDWRFLRGYHQYAYDGKDYIALKEDLRSWTAADMAAQTTKHKWEAAHVAEQLRAYLEGTCVEWLRRYLENGKETLQRTDAP/ILNAMIVKI	initial_guess_benchmark/alignment/6OPD_0_with_pep.tsv	6OPD_0/6OPD_0	initial_guess_benchmark/pandora/6OPD_0/no_modelling_output_dict.json
SGSHSMRYFFTSVSRPGRGEPRFIAVGYVDDTQFVRFDSDAASQRMEPRAPWIEQEGPEYWDQETRNVKAQSQTDRVDLGTLRGYYNQSEAGSHTIQIMYGCDVGSDGRFLRGYRQDAYDGKDYIALNEDLRSWTAADMAAQITKRKWEAAHEAEQLRAYLDGTCVEWLRRYLENGKETLQRTDP/TTAPSLSGK	initial_guess_benchmark/alignment/6O9B_0_with_pep.tsv	6O9B_0/6O9B_0	initial_guess_benchmark/pandora/6O9B_0/no_modelling_output_dict.json
GSHSMRYFFTSVSRPGRGEPRFIAVGYVDDTQFVRFDSDAASQRMEPRAPWIEQEGPEYWDGETRKVKAHSQTHRVDLGTLRGYYNQSEAGSHTVQRMYGCDVGSDWRFLRGYHQYAYDGKDYIALKEDLRSWTAADMAAQTTKHKWEAAHVAEQLRAYLEGTCVEWLRRYLENGKETLQRTDAP/ILNAMITKI	initial_guess_benchmark/alignment/6PTE_0_with_pep.tsv	6PTE_0/6PTE_0	initial_guess_benchmark/pandora/6PTE_0/no_modelling_output_dict.json
GSHSMRYFYTSVSRPGRGEPRFIAVGYVDDTQFVRFDSDAASQRMEPRAPWIEQEGPEYWDQETRNVKAQSQTDRVDLGTLRGYYNQSEDGSHTIQIMYGCDVGPDGRFLRGYRQDAYDGKDYIALNEDLRSWTAADMAAQITKRKWEAAHAAEQQRAYLEGRCVEWLRRYLENGKETLQRTDPP/AIFQSSMTK	initial_guess_benchmark/alignment/6ID4_0_with_pep.tsv	6ID4_0/6ID4_0	initial_guess_benchmark/pandora/6ID4_0/no_modelling_output_dict.json
VADHVASYGVNLYQSYGPSGQFTHEFDGDEEFYVDLERKETVWKLPLFHRLRFDPQFALTNIAVLKHNLNILIKRSNSTAATNEVPEVTVFSKSP/SPEDFVYQFKGMCYFTNGTERVRLVSRSIYNREEIVRFDSDVGEFRAVTLLGLPAAEYWNSQKDILERKRAAVDRVCRHNYQLELRTTLQRRVEP/APFSEQEQPVLG	initial_guess_benchmark/alignment/6PX6_0_with_pep.tsv	6PX6_0/6PX6_0	initial_guess_benchmark/pandora/6PX6_0/no_modelling_output_dict.json
GSHSMRYFFTSVSRPGRGEPRFIAVGYVDDTQFVRFDSDAASQRMEPRAPWIEQEGPEYWDGETRKVKAHSQTHRVDLGTLRGYYNQSEAGSHTVQRMYGCDVGSDWRFLRGYHQYAYDGKDYIALKEDLRSWTAADMAAQTTKHKWEAAHVAEQLRAYLEGTCVEWLRRYLENGKETLQRTDAP/ILDQVPFSV	initial_guess_benchmark/alignment/6VMC_0_with_pep.tsv	6VMC_0/6VMC_0	initial_guess_benchmark/pandora/6VMC_0/no_modelling_output_dict.json
DIVADHVASCGVNLYQFYGPSGQYTHEFDGDEQFYVDLERKETAWRWPEFSKFGGFDPQGALRNMAVAKHNLNIMIKRYNSTAATNEVPEVTVFS/SPEDFVFQFKGMCYFTNGTERVRLVTRYIYNREEYARFDSDVGVYRAVTPQGRPDAEYWNSQKEVLEGTRAELDTVCRHNYEVAFRGILQRRVEP/AGNHAAGILTLGK	initial_guess_benchmark/alignment/6DIG_0_with_pep.tsv	6DIG_0/6DIG_0	initial_guess_benchmark/pandora/6DIG_0/no_modelling_output_dict.json
IVADHVASYGVNLYQSYGPSGQYTHEFDGDEQFYVDLGRKETVWCLPVLRQFRFDPQFALTNIAVLKHNLNSLIKRSNSTAATNEVPEVTVFSKS/SPEDFVYQFKGMCYFTNGTERVRLVSRSIYNREEIVRFDSDVGEFRAVTLLGLPAAEYWNSQKDILERKRAAVDRVCRHNYQLELRTTLQRRVEP/QPFPQPELPYP	initial_guess_benchmark/alignment/6MFG_0_with_pep.tsv	6MFG_0/6MFG_0	initial_guess_benchmark/pandora/6MFG_0/no_modelling_output_dict.json
IKEEHVIIQAEFYLNPDQSGEFMFDFDGDEIFHVDMAKKETVWRLEEFGRFASFEAQGALANIAVDKANLEIMTKRSNYTPITNVPPEVTVLTNS/DTRPRFLEYSTSECHFFNGTERVRFLDRYFYNQEEYVRFDSDVGEFRAVTELGRPDEEYWNSQKDFLEDRRAAVDTYCRHNYGVGESFTVQRRVH/RFYKTLRAEQASQ	initial_guess_benchmark/alignment/6CPN_0_with_pep.tsv	6CPN_0/6CPN_0	initial_guess_benchmark/pandora/6CPN_0/no_modelling_output_dict.json
IVADHVASYGVNLYQSYGPSGQYTHEFDGDEQFYVDLGRKETVWCLPVLRQFRFDPQFALTNIAVLKHNLNSLIKRSNSTAATNEVPEVTVFSKS/SPEDFVYQFKGMCYFTNGTERVRLVSRSIYNREEIVRFDSDVGEFRAVTLLGLPAAEYWNSQKDILERKRAAVDRVCRHNYQLELRTTLQRRVEP/QPFPQPEQPFP	initial_guess_benchmark/alignment/6MFF_0_with_pep.tsv	6MFF_0/6MFF_0	initial_guess_benchmark/pandora/6MFF_0/no_modelling_output_dict.json
EHVIIQAEFYLNPDQSGEFMFDFDGDEIFHVDMAKKETVWRLEEFGRFASFEAQGALANIAVDKANLEIMTKRSNYTPITNVPPEVTVLTNSPVE/GDTRPRFLEYSTSECHFFNGTERVRFLDRYFYNQEEYVRFDSDVGEFRAVTELGRPDEEYWNSQKDFLEDRRAAVDTYCRHNYGVGESFTVQRRV/RFYKTLRAEQASQ	initial_guess_benchmark/alignment/6CQL_0_with_pep.tsv	6CQL_0/6CQL_0	initial_guess_benchmark/pandora/6CQL_0/no_modelling_output_dict.json
IEADHVGTYGISVYQSPGDIGQYTFEFDGDELFYVDLDKKETVWMLPEFGQLASFDPQGGLQNIAVVKHNLGVLTKRSNSTPATNEAPQATVFPK/ERHFVYQFMGECYFTNGTQRIRYVTRYIYNREEYVRYDSDVGEHRAVTELGRPDAEYWNSQPEILERTRAELDTVCRHNYEGPETHTSLRRLEQP/RVSYYGPKTSPVQ	initial_guess_benchmark/alignment/6MNO_0_with_pep.tsv	6MNO_0/6MNO_0	initial_guess_benchmark/pandora/6MNO_0/no_modelling_output_dict.json
KEEHVIIQAEFYLNPDQSGEFMFDFDGDEIFHVDMAKKETVWRLEEFGRFASFEAQGALANIAVDKANLEIMTKRSNYTPITNVPPEVTVLTNSP/RPRFLEYSTSECHFFNGTERVRYLDRYFHNQEENVRFDSDVGEFRAVTELGRPDAEYWNSQKDLLEQKRGRVDNYCRHNYGVVESFTVQRRVHPK/GGIGSDNKVTRRG	initial_guess_benchmark/alignment/7N19_0_with_pep.tsv	7N19_0/7N19_0	initial_guess_benchmark/pandora/7N19_0/no_modelling_output_dict.json
IVADHVASYGVNLYQSYGPSGQFTHEFDGDEEFYVDLERKETVWKLPLFHRLRFDPQFALTNIAVLKHNLNILIKRSNSTAATNEVPEVTVFSKS/SPEDFVYQFKGMCYFTNGTERVRLVSRSIYNREEIVRFDSDVGEFRAVTLLGLPAAEYWNSQKDILERKRAAVDRVCRHNYQLELRTTLQRRVEP/APFSEQEQPVLG	initial_guess_benchmark/alignment/6PY2_0_with_pep.tsv	6PY2_0/6PY2_0	initial_guess_benchmark/pandora/6PY2_0/no_modelling_output_dict.json
DIEADHVGFYGTTVYQSPGDIGQYTHEFDGDELFYVDLDKKKTVWRLPEFGQLILFEPQGGLQCIAAEKHNLGILTKRSNFTPATNEAPQATVFP/RHFVHQFKGECYFTNGTQRIRLVTRYIYNREEYLRFDSDVGEYRAVTELGRHSAEYYNKQYLERTRAELDTACRHNYEETEVPTSLRRLEQPNVC/LVERLYLVCGEEGA	initial_guess_benchmark/alignment/6DFS_0_with_pep.tsv	6DFS_0/6DFS_0	initial_guess_benchmark/pandora/6DFS_0/no_modelling_output_dict.json
EEHVIIQAEFYLNPDQSGEFMFDFDGDEIFHVDMAKKETVWRLEEFGRFASFEAQGALANIAVDKANLEIMTKRSNYTPITNVPPEVTVLTNSPV/GDTRPRFLWQLKFECHFFNGTERVRLLERCIYNQEESVRFDSDVGEYRAVTELGRPDAEYWNSQKDLLEQRRAAVDTYCRHNYGVGESFTVQRRV/RFYKTLRAEQASQ	initial_guess_benchmark/alignment/6CQR_0_with_pep.tsv	6CQR_0/6CQR_0	initial_guess_benchmark/pandora/6CQR_0/no_modelling_output_dict.json
IEADHVGTYGISVYQSPGDIGQYTFEFDGDELFYVDLDKKETVWMLPEFGQLASFDPQGGLQNIAVVKHNLGVLTKRSNSTPATNEAPQATVFPK/ERHFVYQFMGECYFTNGTQRIRYVTRYIYNREEYVRYDSDVGEHRAVTELGRPDAEYWNSQPEILERTRAELDTVCRHNYEGPETHTSLRRLEQP/RVSYYGPKTSPVQ	initial_guess_benchmark/alignment/6MKD_0_with_pep.tsv	6MKD_0/6MKD_0	initial_guess_benchmark/pandora/6MKD_0/no_modelling_output_dict.json
IVADHVASYGVNLYQSYGPSGQYTHEFDGDEQFYVDLGRKETVWSLPVLRQFRFDPQFALTNIAVLKHNLNSLIKRSNSTAATNEVPEVTVFSKS/SPEDFVYQFKGMCYFTNGTERVRLVSRSIYNREEIVRFDSDVGEFRAVTLLGLPAAEYWNSQKDILERKRAAVDRVCRHNYQLELRTTLQRRVEP/APMPMPELPYP	initial_guess_benchmark/alignment/6U3N_0_with_pep.tsv	6U3N_0/6U3N_0	initial_guess_benchmark/pandora/6U3N_0/no_modelling_output_dict.json
EEHVIIQAEFYLNPDQSGEFMFDFDGDEIFHVDMAKKETVWRLEEFGRFASFEAQGALANIAVDKANLEIMTKRSNYTPITNVPPEVTVLTNSPV/MGDTRPRFLWQLKFECHFFNGTERVRLLERCIYNQEESVRFDSDVGEYRAVTELGRPDAEYWNSQKDLLEQRRAAVDTYCRHNYGVGESFTVQRR/ARRPPLAELAALNLSGSRL	initial_guess_benchmark/alignment/6HBY_0_with_pep.tsv	6HBY_0/6HBY_0	initial_guess_benchmark/pandora/6HBY_0/no_modelling_output_dict.json
DIEADHVGFYGTTVYQSPGDIGQYTHEFDGDELFYVDLDKKKTVWRLPEFGQLILFEPQGGLQNIAAEKHNLGILTKRSNFTPATNEAPQATVFP/ERHFVHQFKGECYFTNGTQRIRLVTRYIYNREEYLRFDSDVGEYRAVTELGRHSAEYYNKQYLERTRAELDTACRHNYEETEVPTSLRRLEQPNV/LVERLYLVCGGEG	initial_guess_benchmark/alignment/6DFW_0_with_pep.tsv	6DFW_0/6DFW_0	initial_guess_benchmark/pandora/6DFW_0/no_modelling_output_dict.json
EHVIIQAEFYLNPDQSGEFMFDFDGDEIFHVDMAKKETVWRLEEFGRFASFEAQGALANIAVDKANLEIMTKRSNYTPITNVPPEVTVLTNSPVE/DTRPRFLWQPKRECHFFNGTERVRFLDRYFYNQEESVRFDSDVGEFRAVTELGRPDAEYWNSQKDILEQARAAVDTYCRHNYGVGESFTVQRRVQ/RFYKTLRAEQASQ	initial_guess_benchmark/alignment/6CPO_0_with_pep.tsv	6CPO_0/6CPO_0	initial_guess_benchmark/pandora/6CPO_0/no_modelling_output_dict.json
IEADHVGTYGISVYQSPGDIGQYTFEFDGDELFYVDLDKKETVWMLPEFGQLASFDPQGGLQNIAVVKHNLGVLTKRSNSTPATNEAPQATVFPK/ERHFVYQFMGECYFTNGTQRIRYVTRYIYNREEYVRYDSDVGEHRAVTELGRPDAEYWNSQPEILERTRAELDTVCRHNYEGPETHTSLRRLEQP/RVSYYGPKTSPVQ	initial_guess_benchmark/alignment/6MKR_0_with_pep.tsv	6MKR_0/6MKR_0	initial_guess_benchmark/pandora/6MKR_0/no_modelling_output_dict.json
IEADHVGTYGISVYQSPGDIGQYTFEFDGDELFYVDLDKKETVWMLPEFGQLASFDPQGGLQNIAVVKHNLGVLTKRSNSTPATNEAPQATVFPK/ERHFVYQFMGECYFTNGTQRIRYVTRYIYNREEYVRYDSDVGEHRAVTELGRPDAEYWNSQPEILERTRAELDTVCRHNYEGPETHTSLRRLEQP/RVSYYGPKTSPVQ	initial_guess_benchmark/alignment/6MNN_0_with_pep.tsv	6MNN_0/6MNN_0	initial_guess_benchmark/pandora/6MNN_0/no_modelling_output_dict.json
EHVIIQAEFYLNPDQSGEFMFDFDGDEIFHVDMAKKETVWRLEEFGRFASFEAQGALANIAVDKANLEIMTKRSNYTPITNVPPEVTVLTNSPVE/DTRPRFLEQVKHECHFFNGTERVRFLDRYFYHQEEYVRFDSDVGEYRAVTELGRPDAEYWNSQKDLLEQKRAAVDTYCRHNYGVGESFTVQRRVY/AGFKGEQGPKGEP	initial_guess_benchmark/alignment/6NIX_0_with_pep.tsv	6NIX_0/6NIX_0	initial_guess_benchmark/pandora/6NIX_0/no_modelling_output_dict.json
AIEADHVGTYGISVYQSPGDIGQYTFEFDGDELFYVDLDKKETVWMLPEFGQLASFDPQGGLQNIAVVKHNLGVLTKRSNSTPATNEAPQATVFP/ERHFVYQFMGECYFTNGTQRIRYVTRYIYNREEYVRYDSDVGEHRAVTELGRPDAEYWNSQPEILERTRAELDTVCRHNYEGPETHTSLRRLEQP/RVSYYGPKTSPVQ	initial_guess_benchmark/alignment/6MNM_0_with_pep.tsv	6MNM_0/6MNM_0	initial_guess_benchmark/pandora/6MNM_0/no_modelling_output_dict.json
EEHVIIQAEFYLNPDQSGEFMFDFDGDEIFHVDMAKKETVWRLEEFGRFASFEAQGALANIAVDKANLEIMTKRSNYTPITNVPPEVTVLTNSPV/DTRPRFLWQLKFECHFFNGTERVRLLERCIYNQEESVRFDSDVGEYRAVTELGRPDAEYWNSQKDLLEQRRAAVDTYCRHNYGVGESFTVQRRVE/RFYKTLRAEQASQ	initial_guess_benchmark/alignment/6CQJ_0_with_pep.tsv	6CQJ_0/6CQJ_0	initial_guess_benchmark/pandora/6CQJ_0/no_modelling_output_dict.json
KEEHVIIQAEFYLNPDQSGEFMFDFDGDEIFHVDMAKKETVWRLEEFGRFASFEAQGALANIAVDKANLEIMTKRSNYTPITNVPPEVTVLTNSP/DTRPRFLEQVKHECHFFNGTERVRFLDRYFYHQEEYVRFDSDVGEYRAVTELGRPDAEYWNSQKDLLEQKRAAVDTYCRHNYGVGESFTVQRRVY/KRIAKAVNEKSCNC	initial_guess_benchmark/alignment/5NI9_0_with_pep.tsv	5NI9_0/5NI9_0	initial_guess_benchmark/pandora/5NI9_0/no_modelling_output_dict.json
