target_chainseq	templates_alignfile	targetid
HVSTYAAFVQTHRPTGEFMFEFDEDEMFYVDLDKKETVWHLEEFGQAFSFEAQGGLANIAILNNNLNTLIQRSNHTQ/LFQGRQECYAFNGTQRFLERYIYNREEFARFDSDVGEFRAVTELGRPAAEYWNSQKDILEEKRAVPDRMCRHNYELGGPMTLQRR/EKKYFAATQLEPLAA	proteinmpnn_test_binder_nonbinder/out/alignment/2p_with_pep.tsv	2p/2p
HVSTYAAFVQTHRPTGEFMFEFDEDEMFYVDLDKKETVWHLEEFGQAFSFEAQGGLANIAILNNNLNTLIQRSNHTQ/VYQLRQECYAFNGTQRFLERYIYNREEFVRFDSDVGEFRAVTELGRPDEDYWNSQKDLLEEERAVPDRMCRHNYELDEAVTLQRR/EKKYFAATQLEPLAA	proteinmpnn_test_binder_nonbinder/out/alignment/3p_with_pep.tsv	3p/3p
HVSTYAMFVQTHRPTGEFMFEFDEDEMFYVDLDKKETVWHLEEFGQAFSFEAQGGLANIAISNNNLNTLIQRSNHTQ/LFQGRQECYAFNGTQRFLERYIYNREEFVRFDSDVGEFRAVTELGRPDEEYWNSQKDILEEKRAVPDRMCRHNYELGGPMTLQRR/EKKYFAATQFEPLDA	proteinmpnn_test_binder_nonbinder/out/alignment/1p_with_pep.tsv	1p/1p
HVSTYAMFVQTHRPTGEFMFEFDEDEMFYVDLDKKETVWHLEEFGQAFSFEAQGGLANIAISNNNLNTLIQRSNHTQ/LFQGRQECYAFNGTQRFLERYIYNREEFVRFDSDVGEFRAVTELGRPDEEYWNSQKDILEEKRAVPDRMCRHNYELGGPMTLQRR/VFLQTHIFAEVLKDAIKDL	proteinmpnn_test_binder_nonbinder/out/alignment/0p_with_pep.tsv	0p/0p
HVSTYAAFVQTHRPTGEFMFEFDEDEQFYVDLDKKETVWHLEEFGRAFSFEAQGGLANIAILNNNLNTLIQRSNHTQ/VHQLRQECYAFNGTQRFLERYIYNREEFVRFDSDVGEFRAVTELGRPDEDYWNSQKDLLEEKRAVPDRVCRHNYELDEAVTLQRR/AFKVAATAANVAPAN	proteinmpnn_test_binder_nonbinder/out/alignment/4p_with_pep.tsv	4p/4p
HVSTYAMFVQTHRPTGEFMFEFDEDEMFYVDLDKKETVWHLEEFGQAFSFEAQGGLANIAISNNNLNTLIQRSNHTQ/LFQGRQECYAFNGTQRFLERYIYNREEFVRFDSDVGEFRAVTELGRPDEEYWNSQKDILEEKRAVPDRMCRHNYELGGPMTLQRR/FGMVTLLGSALLSVL	proteinmpnn_test_binder_nonbinder/out/alignment/5p_with_pep.tsv	5p/5p
HVSTYAMFVQTHRPTGEFMFEFDEDEMFYVDLDKKETVWHLEEFGQAFSFEAQGGLANIAISNNNLNTLIQRSNHTQ/LFQGRQECYAFNGTQRFLERYIYNREEFVRFDSDVGEFRAVTELGRPDEEYWNSQKDILEEKRAVPDRMCRHNYELGGPMTLQRR/KQQVIAELYEKFFRI	proteinmpnn_test_binder_nonbinder/out/alignment/6p_with_pep.tsv	6p/6p
HVSTYAAFVQTHRPTGEFMFEFDEDEMFYVDLDKKETVWHLEEFGQAFSFEAQGGLANIAILNNNLNTLIQRSNHTQ/LFQGRQECYAFNGTQRFLERYIYNREEFARFDSDVGEFRAVTELGRPAAEYWNSQKDILEEKRAVPDRMCRHNYELGGPMTLQRR/QAVLTATNFFGINTI	proteinmpnn_test_binder_nonbinder/out/alignment/7p_with_pep.tsv	7p/7p
HVSTYAAFVQTHRPTGEFMFEFDEDEQFYVDLDKKETVWHLEEFGRAFSFEAQGGLANIAILNNNLNTLIQRSNHTQ/LFQGRQECYAFNGTQRFLERYIYNREELVRFDSDVGEFRAVTELGRPEAEYWNSQKDILEEKRAVPDRMCRHNYELDEAVTLQRR/EKKYFAALQFEPLAA	proteinmpnn_test_binder_nonbinder/out/alignment/10p_with_pep.tsv	10p/10p
HVSTYAAFVQTHRPTGEFMFEFDEDEMFYVDLDKKETVWHLEEFGQAFSFEAQGGLANIAILNNNLNTLIQRSNHTQ/VYQLRQECYAFNGTQRFLERYIYNREEFVRFDSDVGEFRAVTELGRPDEDYWNSQKDLLEEERAVPDRMCRHNYELDEAVTLQRR/EYKYFAATQFEPLAA	proteinmpnn_test_binder_nonbinder/out/alignment/9p_with_pep.tsv	9p/9p
HVSTYAAFVQTHRPTGEFMFEFDEDEMFYVDLDKKETVWHLEEFGQAFSFEAQGGLANIAILNNNLNTLIQRSNHTQ/VYQLRQECYAFNGTQRFLERYIYNREEFVRFDSDVGEFRAVTELGRPDEDYWNSQKDLLEEKRAVPDRVCRHNYELDEAVTLQRR/AFKVAATAANAAPAW	proteinmpnn_test_binder_nonbinder/out/alignment/11p_with_pep.tsv	11p/11p
EADHVGFYGTTVYQSPGDIGQYTHEFDGDELFYVDLDKKKTVWRLPEFGQLILFEPQGGLQNIAAEKHNLGILTKRSNFTPA/HFVVQFKGECYYTNGTQRIRLVTRYIYNREEYVRYDSDVGEYRAVTELGRPDAEYWNSQPEILDRTRAEVDTACRHNYEGPETSTSLRR/VRDPQGIRAWVAWRA	proteinmpnn_test_binder_nonbinder/out/alignment/8p_with_pep.tsv	8p/8p
HVSTYAAFVQTHRPTGEFMFEFDEDEQFYVDLDKKETVWHLEEFGRAFSFEAQGGLANIAILNNNLNTLIQRSNHTQ/VHQLRQECYAFNGTQRFLERYIYNREEFVRFDSDVGEFRAVTELGRPDEDYWNSQKDLLEEKRAVPDRVCRHNYELDEAVTLQRR/RTKYTATISGLKPGV	proteinmpnn_test_binder_nonbinder/out/alignment/12p_with_pep.tsv	12p/12p
DHVASCGVNLYQFYGPSGQYTHEFDGDEQFYVDLERKETAWRWPEFSKFGGFDPQGALRNMAVAKHNLNIMIKRYNSTA/FVFQFKGMCYFTNGTERVRLVTRYIYNREEYARFDSDVGVYRAVTPQGRPDAEYWNSQKEVLEGTRAELDTVCRHNYEVAFRGILQRR/INEMTAAAIAYGLDR	proteinmpnn_test_binder_nonbinder/out/alignment/13p_with_pep.tsv	13p/13p
HVSTYAAFVQTHRPTGEFMFEFDEDEMFYVDLDKKETVWHLEEFGQAFSFEAQGGLANIAILNNNLNTLIQRSNHTQ/LFQGRQECYAFNGTQRFLERYIYNREEFVRFDSDVGEFRAVTELGRPDEEYWNSQKDILEEERAVPDRMCRHNYELGGPMTLQRR/VWGQKYFKGNFERLA	proteinmpnn_test_binder_nonbinder/out/alignment/14p_with_pep.tsv	14p/14p
HVSTYAAFVQTHRPTGEFMFEFDEDEQFYVDLDKKETVWHLEEFGRAFSFEAQGGLANIAILNNNLNTLIQRSNHTQ/VYQGRQECYAFNGTQRFLERYIYNREEYARFDSDVGEFRAVTELGRPAAEYWNSQKDILEEKRAVPDRVCRHNYELDEAVTLQRR/EKKYFAATQFEPLAA	proteinmpnn_test_binder_nonbinder/out/alignment/15p_with_pep.tsv	15p/15p
HVSTYAAFVQTHRPTGEFMFEFDEDEMFYVDLDKKETVWHLEEFGQAFSFEAQGGLANIAILNNNLNTLIQRSNHTQ/VYQLRQECYAFNGTQRFLERYIYNREEFVRFDSDVGEFRAVTELGRPDEDYWNSQKDLLEEERAVPDRMCRHNYELDEAVTLQRR/EKKYFEATQFEPLAA	proteinmpnn_test_binder_nonbinder/out/alignment/16p_with_pep.tsv	16p/16p
HVSTYAAFVQTHRPTGEFMFEFDEDEMFYVDLDKKETVWHLEEFGQAFSFEAQGGLANIAILNNNLNTLIQRSNHTQ/VYQLRQECYAFNGTQRFLERYIYNREEFVRFDSDVGEFRAVTELGRPDEDYWNSQKDLLEEERAVPDRMCRHNYELDEAVTLQRR/EWKYFAATQFEPLAA	proteinmpnn_test_binder_nonbinder/out/alignment/18p_with_pep.tsv	18p/18p
HVSTYAMFVQTHRPTGEFMFEFDEDEMFYVDLDKKETVWHLEEFGQAFSFEAQGGLANIAISNNNLNTLIQRSNHTQ/LFQGRQECYAFNGTQRFLERYIYNREEFVRFDSDVGEFRAVTELGRPDEEYWNSQKDILEEKRAVPDRMCRHNYELGGPMTLQRR/EKKYFAQTQFEPLAA	proteinmpnn_test_binder_nonbinder/out/alignment/17p_with_pep.tsv	17p/17p
DHVASCGVNLYQFYGPSGQYTHEFDGDEQFYVDLERKETAWRWPEFSKFGGFDPQGALRNMAVAKHNLNIMIKRYNSTA/FVFQFKGMCYFTNGTERVRLVTRYIYNREEYARFDSDVGVYRAVTPQGRPDAEYWNSQKEVLEGTRAELDTVCRHNYEVAFRGILQRR/AAGTAGTTVYGAFAA	proteinmpnn_test_binder_nonbinder/out/alignment/19p_with_pep.tsv	19p/19p
HVSTYAAFVQTHRPTGEFMFEFDEDEMFYVDLDKKETVWHLEEFGQAFSFEAQGGLANIAILNNNLNTLIQRSNHTQ/VYQLRQECYAFNGTQRFLERYIYNREEFVRFDSDVGEFRAVTELGRPDEDYWNSQKDLLEEERAVPDRMCRHNYELDEAVTLQRR/EKKYFAATIFEPLAA	proteinmpnn_test_binder_nonbinder/out/alignment/20p_with_pep.tsv	20p/20p
DHVASYGVNLYQSYGPSGQYTHEFDGDEQFYVDLGRKETVWCLPVLRQFRFDPQFALTNIAVLKHNLNSLIKRSNSTA/FVYQFKGMCYFTNGTERVRLVSRSIYNREEIVRFDSDVGEFRAVTLLGLPAAEYWNSQKDILERKRAAVDRVCRHNYQLELRTTLQRR/DEINTIFSDYIPYVF	proteinmpnn_test_binder_nonbinder/out/alignment/21p_with_pep.tsv	21p/21p
HVSTYAAFVQTHRPTGEFMFEFDEDEMFYVDLDKKETVWHLEEFGQAFSFEAQGGLANIAILNNNLNTLIQRSNHTQ/LFQGRQECYAFNGTQRFLERYIYNREEFARFDSDVGEFRAVTELGRPAAEYWNSQKDILEEKRAVPDRMCRHNYELGGPMTLQRR/EKKYFAAVQFEPLAA	proteinmpnn_test_binder_nonbinder/out/alignment/23p_with_pep.tsv	23p/23p
DHVASCGVNLYQFYGPSGQYTHEFDGDEEFYVDLERKETAWRWPEFSKFGGFDPQGALRNMAVAKHNLNIMIKRYNSTA/FVYQFKGLCYFTNGTERVRGVTRHIYNREEYVRFDSDVGVYRAVTPQGRPDAEYWNSQKEVLEGARASVDRVCRHNYEVAYRGILQRR/YFVAILDYLNHMAKE	proteinmpnn_test_binder_nonbinder/out/alignment/22p_with_pep.tsv	22p/22p
DHVASYGVNLYQSYGPSGQYTHEFDGDEQFYVDLGRKETVWCLPVLRQFRFDPQFALTNIAVLKHNLNSLIKRSNSTA/FVYQFKAMCYFTNGTERVRYVTRYIYNREEYARFDSDVEVYRAVTPLGPPDAEYWNSQKEVLERTRAELDTVCRHNYQLELRTTLQRR/IAATAANAAPTNDKF	proteinmpnn_test_binder_nonbinder/out/alignment/24p_with_pep.tsv	24p/24p
HVSTYAAFVQTHRPTGEFMFEFDEDEMFYVDLDKKETVWHLEEFGQAFSFEAQGGLANIAILNNNLNTLIQRSNHTQ/VYQLRQECYAFNGTQRFLERYIYNREEFVRFDSDVGEFRAVTELGRPDEDYWNSQKDLLEEERAVPDRMCRHNYELDEAVTLQRR/EKKYFAATQFERLAA	proteinmpnn_test_binder_nonbinder/out/alignment/27p_with_pep.tsv	27p/27p
HVSTYAAFVQTHRPTGEFMFEFDEDEQFYVDLDKKETVWHLEEFGRAFSFEAQGGLANIAILNNNLNTLIQRSNHTQ/VHQLRQECYAFNGTQRFLERYIYNREEFVRFDSDVGEFRAVTELGRPDEDYWNSQKDLLEEKRAVPDRVCRHNYELDEAVTLQRR/EKKYFAAEQFEPLAA	proteinmpnn_test_binder_nonbinder/out/alignment/26p_with_pep.tsv	26p/26p
HVSTYAMFVQTHRPTGEFMFEFDEDEMFYVDLDKKETVWHLEEFGQAFSFEAQGGLANIAISNNNLNTLIQRSNHTQ/LFQGRQECYAFNGTQRFLERYIYNREEFVRFDSDVGEFRAVTELGRPDEEYWNSQKDILEEKRAVPDRMCRHNYELGGPMTLQRR/EVKYFAATQFEPLAA	proteinmpnn_test_binder_nonbinder/out/alignment/25p_with_pep.tsv	25p/25p
HVSTYAAFVQTHRPTGEFMFEFDEDEQFYVDLDKKETVWHLEEFGRAFSFEAQGGLANIAILNNNLNTLIQRSNHTQ/VYQGRQECYAFNGTQRFLERYIYNREEYARFDSDVGEFRAVTELGRPAAEYWNSQKDILEEKRAVPDRVCRHNYELDEAVTLQRR/EKKYFAATQFEPLMA	proteinmpnn_test_binder_nonbinder/out/alignment/28p_with_pep.tsv	28p/28p
HVSTYAAFVQTHRPTGEFMFEFDEDEMFYVDLDKKETVWHLEEFGQAFSFEAQGGLANIAILNNNLNTLIQRSNHTQ/VYQLRQECYAFNGTQRFLERYIYNREEFVRFDSDVGEFRAVTELGRPDEDYWNSQKDLLEEERAVPDRMCRHNYELDEAVTLQRR/EKKYFAATPFEPLAA	proteinmpnn_test_binder_nonbinder/out/alignment/29p_with_pep.tsv	29p/29p
DHVASCGVNLYQFYGPSGQYTHEFDGDEQFYVDLERKETAWRWPEFSKFGGFDPQGALRNMAVAKHNLNIMIKRYNSTA/FVFQFKGMCYFTNGTERVRLVTRYIYNREEYARFDSDVGVYRAVTPQGRPDAEYWNSQKEVLEGTRAELDTVCRHNYEVAFRGILQRR/LIEKINAGFKAALAA	proteinmpnn_test_binder_nonbinder/out/alignment/30p_with_pep.tsv	30p/30p
HVSTYAAFVQTHRPTGEFMFEFDEDEMFYVDLDKKETVWHLEEFGQAFSFEAQGGLANIAILNNNLNTLIQRSNHTQ/LFQGRQECYAFNGTQRFLERYIYNREEFARFDSDVGEFRAVTELGRPAAEYWNSQKDILEEKRAVPDRMCRHNYELGGPMTLQRR/EKKYFAATQFERLAA	proteinmpnn_test_binder_nonbinder/out/alignment/31p_with_pep.tsv	31p/31p
DHVASYGVNLYQSYGPSGQYTHEFDGDEQFYVDLGRKETVWCLPVLRQFRFDPQFALTNIAVLKHNLNSLIKRSNSTA/FVYQFKAMCYFTNGTERVRYVTRYIYNREEYARFDSDVEVYRAVTPLGPPDAEYWNSQKEVLERTRAELDTVCRHNYQLELRTTLQRR/INVGFKAAVAAAASV	proteinmpnn_test_binder_nonbinder/out/alignment/32p_with_pep.tsv	32p/32p
HVSTYAAFVQTHRPTGEFMFEFDEDEQFYVDLDKKETVWHLEEFGRAFSFEAQGGLANIAILNNNLNTLIQRSNHTQ/VYQGRQECYAFNGTQRFLERYIYNREEYARFDSDVGEFRAVTELGRPAAEYWNSQKDILEEKRAVPDRVCRHNYELDEAVTLQRR/EKKYFAQTQFEPLAA	proteinmpnn_test_binder_nonbinder/out/alignment/34p_with_pep.tsv	34p/34p
HVSTYAAFVQTHRPTGEFMFEFDEDEQFYVDLDKKETVWHLEEFGRAFSFEAQGGLANIAILNNNLNTLIQRSNHTQ/VHQLRQECYAFNGTQRFLERYIYNREEFVRFDSDVGEFRAVTELGRPDEDYWNSQKDLLEEKRAVPDRVCRHNYELDEAVTLQRR/EKKYFAATQFEPLAH	proteinmpnn_test_binder_nonbinder/out/alignment/33p_with_pep.tsv	33p/33p
HVSTYAMFVQTHRPTGEFMFEFDEDEMFYVDLDKKETVWHLEEFGQAFSFEAQGGLANIAISNNNLNTLIQRSNHTQ/LFQGRQECYAFNGTQRFLERYIYNREEFVRFDSDVGEFRAVTELGRPDEEYWNSQKDILEEKRAVPDRMCRHNYELGGPMTLQRR/EKKYFFATQFEPLAA	proteinmpnn_test_binder_nonbinder/out/alignment/35p_with_pep.tsv	35p/35p
EADHVGFYGTTVYQSPGDIGQYTHEFDGDELFYVDLDKKKTVWRLPEFGQLILFEPQGGLQNIAAEKHNLGILTKRSNFTPA/HFVVQFKGECYYTNGTQRIRLVTRYIYNREEYVRYDSDVGEYRAVTELGRPDAEYWNSQPEILDRTRAEVDTACRHNYEGPETSTSLRR/AKRKTVTAMDVVYAL	proteinmpnn_test_binder_nonbinder/out/alignment/36p_with_pep.tsv	36p/36p
DHVASCGVNLYQFYGPSGQYTHEFDGDEQFYVDLERKETAWRWPEFSKFGGFDPQGALRNMAVAKHNLNIMIKRYNSTA/FVFQFKGMCYFTNGTERVRLVTRYIYNREEYARFDSDVGVYRAVTPQGRPDAEYWNSQKEVLEGTRAELDTVCRHNYEVAFRGILQRR/AAVTAGTTVYGAFAA	proteinmpnn_test_binder_nonbinder/out/alignment/37p_with_pep.tsv	37p/37p
DHVASCGVNLYQFYGPSGQFTHEFDGDEQFYVDLEKKETAWRWPEFSKFGGFDPQGALRNMAVAKHNLNIMIKRYNSTA/FVYQFKGMCYFTNGTERVRLVTRHIYNREEYARFDSDVGVYRAVTPQGRPDAEYWNSQKEVLEGTRAELDTVCRHNYEVAFRGILQRR/AAAFAGTTVYGAFAA	proteinmpnn_test_binder_nonbinder/out/alignment/38p_with_pep.tsv	38p/38p
DHVASCGVNLYQFYGPSGQYTHEFDGDEEFYVDLERKETAWRWPEFSKFGGFDPQGALRNMAVAKHNLNIMIKRYNSTA/FVYQFKGLCYFTNGTERVRGVTRHIYNREEYVRFDSDVGVYRAVTPQGRPVAEYWNSQKEVLEGARASVDRVCRHNYEVAYRGILQRR/EKKYFAATQFEDLAA	proteinmpnn_test_binder_nonbinder/out/alignment/39p_with_pep.tsv	39p/39p
HVSTYAAFVQTHRPTGEFMFEFDEDEMFYVDLDKKETVWHLEEFGQAFSFEAQGGLANIAILNNNLNTLIQRSNHTQ/VYQLRQECYAFNGTQRFLERYIYNREEFVRFDSDVGEFRAVTELGRPDEDYWNSQKDLLEEERAVPDRMCRHNYELDEAVTLQRR/EKKAFAATQFEPLAA	proteinmpnn_test_binder_nonbinder/out/alignment/40p_with_pep.tsv	40p/40p
DHVASCGVNLYQFYGPSGQYTHEFDGDEEFYVDLERKETAWRWPEFSKFGGFDPQGALRNMAVAKHNLNIMIKRYNSTA/FVYQFKGLCYFTNGTERVRGVTRHIYNREEYVRFDSDVGVYRAVTPQGRPVAEYWNSQKEVLEGARASVDRVCRHNYEVAYRGILQRR/SQDLELSWNLNGLQAD	proteinmpnn_test_binder_nonbinder/out/alignment/42p_with_pep.tsv	42p/42p
HVSTYAAFVQTHRPTGEFMFEFDEDEMFYVDLDKKETVWHLEEFGQAFSFEAQGGLANIAILNNNLNTLIQRSNHTQ/LFQGRQECYAFNGTQRFLERYIYNREEFARFDSDVGEFRAVTELGRPAAEYWNSQKDILEEKRAVPDRMCRHNYELGGPMTLQRR/EKKYFWATQFEPLAA	proteinmpnn_test_binder_nonbinder/out/alignment/41p_with_pep.tsv	41p/41p
HVSTYAAFVQTHRPTGEFMFEFDEDEMFYVDLDKKETVWHLEEFGQAFSFEAQGGLANIAILNNNLNTLIQRSNHTQ/VYQLRQECYAFNGTQRFLERYIYNREEFVRFDSDVGEFRAVTELGRPDEDYWNSQKDLLEEKRAVPDRVCRHNYELDEAVTLQRR/FLFQRAVAREAIIAL	proteinmpnn_test_binder_nonbinder/out/alignment/43p_with_pep.tsv	43p/43p
DHVASYGVNLYQSYGPSGQYTHEFDGDEQFYVDLGRKETVWCLPVLRQFRFDPQFALTNIAVLKHNLNSLIKRSNSTA/FVFQFKGMCYFTNGTERVRGVTRYIYNREEYARFDSDVGVYRAVTPLGRLDAEYWNSQKDILEEDRASVDTVCRHNYQLELRTTLQRR/TKPSLFKVRNGGEIG	proteinmpnn_test_binder_nonbinder/out/alignment/44p_with_pep.tsv	44p/44p
HVSTYAAFVQTHRPTGEFMFEFDEDEQFYVDLDKKETVWHLEEFGRAFSFEAQGGLANIAILNNNLNTLIQRSNHTQ/LFQGRQECYAFNGTQRFLERYIYNREELVRFDSDVGEFRAVTELGRPEAEYWNSQKDILEEKRAVPDRMCRHNYELDEAVTLQRR/THIFAEVLKDAIKDL	proteinmpnn_test_binder_nonbinder/out/alignment/45p_with_pep.tsv	45p/45p
HVSTYAAFVQTHRPTGEFMFEFDEDEMFYVDLDKKETVWHLEEFGQAFSFEAQGGLANIAILNNNLNTLIQRSNHTQ/LFQGRQECYAFNGTQRFLERYIYNREEFARFDSDVGEFRAVTELGRPAAEYWNSQKDILEEKRAVPDRMCRHNYELGGPMTLQRR/GPLLVLQAGFFLLTR	proteinmpnn_test_binder_nonbinder/out/alignment/46p_with_pep.tsv	46p/46p
HVSTYAAFVQTHRPTGEFMFEFDEDEMFYVDLDKKETVWHLEEFGQAFSFEAQGGLANIAILNNNLNTLIQRSNHTQ/VYQLRQECYAFNGTQRFLERYIYNREEFVRFDSDVGEFRAVTELGRPDEDYWNSQKDLLEEKRAVPDRVCRHNYELDEAVTLQRR/GFKAAVAAAASVP	proteinmpnn_test_binder_nonbinder/out/alignment/47p_with_pep.tsv	47p/47p
HVSTYAMFVQTHRPTGEFMFEFDEDEMFYVDLDKKETVWHLEEFGQAFSFEAQGGLANIAISNNNLNTLIQRSNHTQ/LFQGRQECYAFNGTQRFLERYIYNREEFVRFDSDVGEFRAVTELGRPDEEYWNSQKDILEEKRAVPDRMCRHNYELGGPMTLQRR/EKKYFAATQFYPLAA	proteinmpnn_test_binder_nonbinder/out/alignment/48p_with_pep.tsv	48p/48p
DHVASYGVNLYQSYGPSGQYTHEFDGDEQFYVDLGRKETVWCLPVLRQFRFDPQFALTNIAVLKHNLNSLIKRSNSTA/FVYQFKGMCYFTNGTERVRLVSRSIYNREEIVRFDSDVGEFRAVTLLGLPAAEYWNSQKDILERKRAAVDRVCRHNYQLELRTTLQRR/LIDDVIAILPVDELY	proteinmpnn_test_binder_nonbinder/out/alignment/49p_with_pep.tsv	49p/49p
HVSTYAAFVQTHRPTGEFMFEFDEDEMFYVDLDKKETVWHLEEFGQAFSFEAQGGLANIAILNNNLNTLIQRSNHTQ/VYQLRQECYAFNGTQRFLERYIYNREEFVRFDSDVGEFRAVTELGRPDEDYWNSQKDLLEEERAVPDRMCRHNYELDEAVTLQRR/EKKYFAADQFEPLAA	proteinmpnn_test_binder_nonbinder/out/alignment/50p_with_pep.tsv	50p/50p
DHVASYGVNLYQSYGPSGQYTHEFDGDEQFYVDLGRKETVWCLPVLRQFRFDPQFALTNIAVLKHNLNSLIKRSNSTA/FVYQFKAMCYFTNGTERVRYVTRYIYNREEYARFDSDVEVYRAVTPLGPPDAEYWNSQKEVLERTRAELDTVCRHNYQLELRTTLQRR/STNIRQAGVQYSR	proteinmpnn_test_binder_nonbinder/out/alignment/51p_with_pep.tsv	51p/51p
HVSTYAAFVQTHRPTGEFMFEFDEDEQFYVDLDKKETVWHLEEFGRAFSFEAQGGLANIAILNNNLNTLIQRSNHTQ/LFQGRQECYAFNGTQRFLERYIYNREELVRFDSDVGEFRAVTELGRPEAEYWNSQKDILEEKRAVPDRMCRHNYELDEAVTLQRR/EKKYFAATQFEPTAA	proteinmpnn_test_binder_nonbinder/out/alignment/52p_with_pep.tsv	52p/52p
HVSTYAMFVQTHRPTGEFMFEFDEDEMFYVDLDKKETVWHLEEFGQAFSFEAQGGLANIAISNNNLNTLIQRSNHTQ/LFQGRQECYAFNGTQRFLERYIYNREEFVRFDSDVGEFRAVTELGRPDEEYWNSQKDILEEKRAVPDRMCRHNYELGGPMTLQRR/WKKYFAATQFEPLAA	proteinmpnn_test_binder_nonbinder/out/alignment/53p_with_pep.tsv	53p/53p
DHVASCGVNLYQFYGPSGQYTHEFDGDEEFYVDLERKETAWRWPEFSKFGGFDPQGALRNMAVAKHNLNIMIKRYNSTA/FVYQFKGLCYFTNGTERVRGVTRHIYNREEYVRFDSDVGVYRAVTPQGRPVAEYWNSQKEVLEGARASVDRVCRHNYEVAYRGILQRR/GVLVATNFFGINTIP	proteinmpnn_test_binder_nonbinder/out/alignment/54p_with_pep.tsv	54p/54p
HVSTYAAFVQTHRPTGEFMFEFDEDEMFYVDLDKKETVWHLEEFGQAFSFEAQGGLANIAILNNNLNTLIQRSNHTQ/VYQLRQECYAFNGTQRFLERYIYNREEFVRFDSDVGEFRAVTELGRPDEDYWNSQKDLLEEERAVPDRMCRHNYELDEAVTLQRR/EKKYFAATQFEPLRA	proteinmpnn_test_binder_nonbinder/out/alignment/55p_with_pep.tsv	55p/55p
DHVASYGVNLYQSYGPSGQYTHEFDGDEQFYVDLGRKETVWCLPVLRQFRFDPQFALTNIAVLKHNLNSLIKRSNSTA/FVYQFKAMCYFTNGTERVRYVTRYIYNREEYARFDSDVEVYRAVTPLGPPDAEYWNSQKEVLERTRAELDTVCRHNYQLELRTTLQRR/DVKFPGGGQIVGGVS	proteinmpnn_test_binder_nonbinder/out/alignment/56p_with_pep.tsv	56p/56p
HVSTYAAFVQTHRPTGEFMFEFDEDEMFYVDLDKKETVWHLEEFGQAFSFEAQGGLANIAILNNNLNTLIQRSNHTQ/VYQLRQECYAFNGTQRFLERYIYNREEFVRFDSDVGEFRAVTELGRPDEDYWNSQKDLLEEERAVPDRMCRHNYELDEAVTLQRR/EKKYFAATQFRPLAA	proteinmpnn_test_binder_nonbinder/out/alignment/57p_with_pep.tsv	57p/57p
HVSTYAMFVQTHRPTGEFMFEFDEDEMFYVDLDKKETVWHLEEFGQAFSFEAQGGLANIAISNNNLNTLIQRSNHTQ/LFQGRQECYAFNGTQRFLERYIYNREEFVRFDSDVGEFRAVTELGRPDEEYWNSQKDILEEKRAVPDRMCRHNYELGGPMTLQRR/EKKYFAATIFEPLAA	proteinmpnn_test_binder_nonbinder/out/alignment/58p_with_pep.tsv	58p/58p
DHVASCGVNLYQFYGPSGQFTHEFDGDEQFYVDLEKKETAWRWPEFSKFGGFDPQGALRNMAVAKHNLNIMIKRYNSTA/FVYQFKGMCYFTNGTERVRLVTRHIYNREEYARFDSDVGVYRAVTPQGRPDAEYWNSQKEVLEGTRAELDTVCRHNYEVAFRGILQRR/INEPTAAAIAYGLDR	proteinmpnn_test_binder_nonbinder/out/alignment/59p_with_pep.tsv	59p/59p
HVSTYAAFVQTHRPTGEFMFEFDEDEMFYVDLDKKETVWHLEEFGQAFSFEAQGGLANIAILNNNLNTLIQRSNHTQ/VYQLRQECYAFNGTQRFLERYIYNREEFVRFDSDVGEFRAVTELGRPDEDYWNSQKDLLEEKRAVPDRVCRHNYELDEAVTLQRR/DSYKFIPTLVAAVKQ	proteinmpnn_test_binder_nonbinder/out/alignment/60p_with_pep.tsv	60p/60p
HVSTYAAFVQTHRPTGEFMFEFDEDEMFYVDLDKKETVWHLEEFGQAFSFEAQGGLANIAILNNNLNTLIQRSNHTQ/VYQLRQECYAFNGTQRFLERYIYNREEFVRFDSDVGEFRAVTELGRPDEDYWNSQKDLLEEERAVPDRMCRHNYELDEAVTLQRR/EKKYFAATYFEPLAA	proteinmpnn_test_binder_nonbinder/out/alignment/61p_with_pep.tsv	61p/61p
HVSTYAAFVQTHRPTGEFMFEFDEDEMFYVDLDKKETVWHLEEFGQAFSFEAQGGLANIAILNNNLNTLIQRSNHTQ/VYQLRQECYAFNGTQRFLERYIYNREEFVRFDSDVGEFRAVTELGRPDEDYWNSQKDLLEEERAVPDRMCRHNYELDEAVTLQRR/EIKYFAATQFEPLAA	proteinmpnn_test_binder_nonbinder/out/alignment/62p_with_pep.tsv	62p/62p
HVSTYAAFVQTHRPTGEFMFEFDEDEMFYVDLDKKETVWHLEEFGQAFSFEAQGGLANIAILNNNLNTLIQRSNHTQ/LFQGRQECYAFNGTQRFLERYIYNREEFARFDSDVGEFRAVTELGRPAAEYWNSQKDILEEKRAVPDRMCRHNYELGGPMTLQRR/EKKDFAATQFEPLAA	proteinmpnn_test_binder_nonbinder/out/alignment/63p_with_pep.tsv	63p/63p
HVSTYAAFVQTHRPTGEFMFEFDEDEQFYVDLDKKETVWHLEEFGRAFSFEAQGGLANIAILNNNLNTLIQRSNHTQ/VHQLRQECYAFNGTQRFLERYIYNREEFVRFDSDVGEFRAVTELGRPDEDYWNSQKDLLEEKRAVPDRVCRHNYELDEAVTLQRR/AFKVAATAAMAAPAN	proteinmpnn_test_binder_nonbinder/out/alignment/64p_with_pep.tsv	64p/64p
HVSTYAMFVQTHRPTGEFMFEFDEDEMFYVDLDKKETVWHLEEFGQAFSFEAQGGLANIAISNNNLNTLIQRSNHTQ/LFQGRQECYAFNGTQRFLERYIYNREEFVRFDSDVGEFRAVTELGRPDEEYWNSQKDILEEKRAVPDRMCRHNYELGGPMTLQRR/EKKYFAAGQFEPLAA	proteinmpnn_test_binder_nonbinder/out/alignment/65p_with_pep.tsv	65p/65p
DHVASCGVNLYQFYGPSGQYTHEFDGDEQFYVDLERKETAWRWPEFSKFGGFDPQGALRNMAVAKHNLNIMIKRYNSTA/FVFQFKGMCYFTNGTERVRLVTRYIYNREEYARFDSDVGVYRAVTPQGRPDAEYWNSQKEVLEGTRAELDTVCRHNYEVAFRGILQRR/EQKLIEKINAGFKAALAAAA	proteinmpnn_test_binder_nonbinder/out/alignment/66p_with_pep.tsv	66p/66p
HVSTYAMFVQTHRPTGEFMFEFDEDEMFYVDLDKKETVWHLEEFGQAFSFEAQGGLANIAISNNNLNTLIQRSNHTQ/LFQGRQECYAFNGTQRFLERYIYNREEFVRFDSDVGEFRAVTELGRPDEEYWNSQKDILEEKRAVPDRMCRHNYELGGPMTLQRR/EKKYFAATQFEPVAA	proteinmpnn_test_binder_nonbinder/out/alignment/67p_with_pep.tsv	67p/67p
HVSTYAAFVQTHRPTGEFMFEFDEDEMFYVDLDKKETVWHLEEFGQAFSFEAQGGLANIAILNNNLNTLIQRSNHTQ/VYQLRQECYAFNGTQRFLERYIYNREEFVRFDSDVGEFRAVTELGRPDEDYWNSQKDLLEEERAVPDRMCRHNYELDEAVTLQRR/EKKYFAATQFEPLAE	proteinmpnn_test_binder_nonbinder/out/alignment/68p_with_pep.tsv	68p/68p
HVSTYAAFVQTHRPTGEFMFEFDEDEQFYVDLDKKETVWHLEEFGRAFSFEAQGGLANIAILNNNLNTLIQRSNHTQ/VHQLRQECYAFNGTQRFLERYIYNREEFVRFDSDVGEFRAVTELGRPDEDYWNSQKDLLEEKRAVPDRVCRHNYELDEAVTLQRR/AFKVAATAINAAPAN	proteinmpnn_test_binder_nonbinder/out/alignment/69p_with_pep.tsv	69p/69p
HVSTYAAFVQTHRPTGEFMFEFDEDEMFYVDLDKKETVWHLEEFGQAFSFEAQGGLANIAILNNNLNTLIQRSNHTQ/VYQLRQECYAFNGTQRFLERYIYNREEFVRFDSDVGEFRAVTELGRPDEDYWNSQKDLLEEERAVPDRMCRHNYELDEAVTLQRR/EKKYFAHTQFEPLAA	proteinmpnn_test_binder_nonbinder/out/alignment/70p_with_pep.tsv	70p/70p
DHVASCGVNLYQFYGPSGQYTHEFDGDEQFYVDLERKETAWRWPEFSKFGGFDPQGALRNMAVAKHNLNIMIKRYNSTA/FVFQFKGMCYFTNGTERVRLVTRYIYNREEYARFDSDVGVYRAVTPQGRPDAEYWNSQKEVLEGTRAELDTVCRHNYEVAFRGILQRR/AEATAGTTVYGAFAA	proteinmpnn_test_binder_nonbinder/out/alignment/71p_with_pep.tsv	71p/71p
DHVASCGVNLYQFYGPSGQFTHEFDGDEQFYVDLEKKETAWRWPEFSKFGGFDPQGALRNMAVAKHNLNIMIKRYNSTA/FVYQFKGMCYFTNGTERVRLVTRHIYNREEYARFDSDVGVYRAVTPQGRPDAEYWNSQKEVLEGTRAELDTVCRHNYEVAFRGILQRR/KRWIILGLNKIVRMYSPTSI	proteinmpnn_test_binder_nonbinder/out/alignment/72p_with_pep.tsv	72p/72p
HVSTYAAFVQTHRPTGEFMFEFDEDEQFYVDLDKKETVWHLEEFGRAFSFEAQGGLANIAILNNNLNTLIQRSNHTQ/LFQGRQECYAFNGTQRFLERYIYNREELVRFDSDVGEFRAVTELGRPEAEYWNSQKDILEEKRAVPDRMCRHNYELDEAVTLQRR/EKKYFAATQFEPLIA	proteinmpnn_test_binder_nonbinder/out/alignment/73p_with_pep.tsv	73p/73p
HVSTYAMFVQTHRPTGEFMFEFDEDEMFYVDLDKKETVWHLEEFGQAFSFEAQGGLANIAISNNNLNTLIQRSNHTQ/LFQGRQECYAFNGTQRFLERYIYNREEFVRFDSDVGEFRAVTELGRPDEEYWNSQKDILEEKRAVPDRMCRHNYELGGPMTLQRR/IKKYFAATQFEPLAA	proteinmpnn_test_binder_nonbinder/out/alignment/74p_with_pep.tsv	74p/74p
HVSTYAAFVQTHRPTGEFMFEFDEDEQFYVDLDKKETVWHLEEFGRAFSFEAQGGLANIAILNNNLNTLIQRSNHTQ/VYQGRQECYAFNGTQRFLERYIYNREEYARFDSDVGEFRAVTELGRPAAEYWNSQKDILEEKRAVPDRVCRHNYELDEAVTLQRR/KKKYFAATQFEPLAA	proteinmpnn_test_binder_nonbinder/out/alignment/75p_with_pep.tsv	75p/75p
HVSTYAAFVQTHRPTGEFMFEFDEDEMFYVDLDKKETVWHLEEFGQAFSFEAQGGLANIAILNNNLNTLIQRSNHTQ/LFQGRQECYAFNGTQRFLERYIYNREEFARFDSDVGEFRAVTELGRPAAEYWNSQKDILEEKRAVPDRMCRHNYELGGPMTLQRR/EKKGFAATQFEPLAA	proteinmpnn_test_binder_nonbinder/out/alignment/76p_with_pep.tsv	76p/76p
HVSTYAAFVQTHRPTGEFMFEFDEDEMFYVDLDKKETVWHLEEFGQAFSFEAQGGLANIAILNNNLNTLIQRSNHTQ/LFQGRQECYAFNGTQRFLERYIYNREEFARFDSDVGEFRAVTELGRPAAEYWNSQKDILEEKRAVPDRMCRHNYELGGPMTLQRR/EDPLFQLVSKLYEVV	proteinmpnn_test_binder_nonbinder/out/alignment/77p_with_pep.tsv	77p/77p
HVSTYAMFVQTHRPTGEFMFEFDEDEMFYVDLDKKETVWHLEEFGQAFSFEAQGGLANIAISNNNLNTLIQRSNHTQ/LFQGRQECYAFNGTQRFLERYIYNREEFVRFDSDVGEFRAVTELGRPDEEYWNSQKDILEEKRAVPDRMCRHNYELGGPMTLQRR/YRQIRSGERFLKIWS	proteinmpnn_test_binder_nonbinder/out/alignment/78p_with_pep.tsv	78p/78p
HVSTYAAFVQTHRPTGEFMFEFDEDEMFYVDLDKKETVWHLEEFGQAFSFEAQGGLANIAILNNNLNTLIQRSNHTQ/VYQLRQECYAFNGTQRFLERYIYNREEFVRFDSDVGEFRAVTELGRPDEDYWNSQKDLLEEERAVPDRMCRHNYELDEAVTLQRR/YKKYFAATQFEPLAA	proteinmpnn_test_binder_nonbinder/out/alignment/79p_with_pep.tsv	79p/79p
DHVASCGVNLYQFYGPSGQYTHEFDGDEQFYVDLERKETAWRWPEFSKFGGFDPQGALRNMAVAKHNLNIMIKRYNSTA/FVFQFKGMCYFTNGTERVRLVTRYIYNREEYARFDSDVGVYRAVTPQGRPDAEYWNSQKEVLEGTRAELDTVCRHNYEVAFRGILQRR/INEPTAAAIAYGLDL	proteinmpnn_test_binder_nonbinder/out/alignment/80p_with_pep.tsv	80p/80p
DHVASCGVNLYQFYGPSGQYTHEFDGDEQFYVDLERKETAWRWPEFSKFGGFDPQGALRNMAVAKHNLNIMIKRYNSTA/FVFQFKGMCYFTNGTERVRLVTRYIYNREEYARFDSDVGVYRAVTPQGRPDAEYWNSQKEVLEGTRAELDTVCRHNYEVAFRGILQRR/FLHATDLLPAY	proteinmpnn_test_binder_nonbinder/out/alignment/81p_with_pep.tsv	81p/81p
HVSTYAAFVQTHRPTGEFMFEFDEDEMFYVDLDKKETVWHLEEFGQAFSFEAQGGLANIAILNNNLNTLIQRSNHTQ/VYQLRQECYAFNGTQRFLERYIYNREEFVRFDSDVGEFRAVTELGRPDEDYWNSQKDLLEEERAVPDRMCRHNYELDEAVTLQRR/EKKDFAATQFEPLAA	proteinmpnn_test_binder_nonbinder/out/alignment/82p_with_pep.tsv	82p/82p
HVSTYAAFVQTHRPTGEFMFEFDEDEQFYVDLDKKETVWHLEEFGRAFSFEAQGGLANIAILNNNLNTLIQRSNHTQ/VYQGRQECYAFNGTQRFLERYIYNREEYARFDSDVGEFRAVTELGRPAAEYWNSQKDILEEKRAVPDRVCRHNYELDEAVTLQRR/EKKYFAAFQFEPLAA	proteinmpnn_test_binder_nonbinder/out/alignment/83p_with_pep.tsv	83p/83p
DHVASCGVNLYQFYGPSGQYTHEFDGDEQFYVDLERKETAWRWPEFSKFGGFDPQGALRNMAVAKHNLNIMIKRYNSTA/FVFQFKGMCYFTNGTERVRLVTRYIYNREEYARFDSDVGVYRAVTPQGRPDAEYWNSQKEVLEGTRAELDTVCRHNYEVAFRGILQRR/INEPTAAAIAYGLDS	proteinmpnn_test_binder_nonbinder/out/alignment/84p_with_pep.tsv	84p/84p
HVSTYAAFVQTHRPTGEFMFEFDEDEMFYVDLDKKETVWHLEEFGQAFSFEAQGGLANIAILNNNLNTLIQRSNHTQ/VYQLRQECYAFNGTQRFLERYIYNREEFVRFDSDVGEFRAVTELGRPDEDYWNSQKDLLEEERAVPDRMCRHNYELDEAVTLQRR/KYFAATQFEPLAARL	proteinmpnn_test_binder_nonbinder/out/alignment/85p_with_pep.tsv	85p/85p
HVSTYAAFVQTHRPTGEFMFEFDEDEMFYVDLDKKETVWHLEEFGQAFSFEAQGGLANIAILNNNLNTLIQRSNHTQ/LFQGRQECYAFNGTQRFLERYIYNREEFARFDSDVGEFRAVTELGRPAAEYWNSQKDILEEKRAVPDRMCRHNYELGGPMTLQRR/KKKYFAATQFEPLAA	proteinmpnn_test_binder_nonbinder/out/alignment/86p_with_pep.tsv	86p/86p
HVSTYAAFVQTHRPTGEFMFEFDEDEQFYVDLDKKETVWHLEEFGRAFSFEAQGGLANIAILNNNLNTLIQRSNHTQ/VHQLRQECYAFNGTQRFLERYIYNREEFVRFDSDVGEFRAVTELGRPDEDYWNSQKDLLEEKRAVPDRVCRHNYELDEAVTLQRR/AFKVAATAANAAPCN	proteinmpnn_test_binder_nonbinder/out/alignment/87p_with_pep.tsv	87p/87p
DHVASYGVNLYQSYGPSGQYTHEFDGDEQFYVDLGRKETVWCLPVLRQFRFDPQFALTNIAVLKHNLNSLIKRSNSTA/FVYQFKGMCYFTNGTERVRLVSRSIYNREEIVRFDSDVGEFRAVTLLGLPAAEYWNSQKDILERKRAAVDRVCRHNYQLELRTTLQRR/AFILDMDNLFPKV	proteinmpnn_test_binder_nonbinder/out/alignment/88p_with_pep.tsv	88p/88p
HVSTYAAFVQTHRPTGEFMFEFDEDEMFYVDLDKKETVWHLEEFGQAFSFEAQGGLANIAILNNNLNTLIQRSNHTQ/VYQLRQECYAFNGTQRFLERYIYNREEFVRFDSDVGEFRAVTELGRPDEDYWNSQKDLLEEERAVPDRMCRHNYELDEAVTLQRR/AKKYFAATQFEPLAA	proteinmpnn_test_binder_nonbinder/out/alignment/89p_with_pep.tsv	89p/89p
HVSTYAMFVQTHRPTGEFMFEFDEDEMFYVDLDKKETVWHLEEFGQAFSFEAQGGLANIAISNNNLNTLIQRSNHTQ/LFQGRQECYAFNGTQRFLERYIYNREEFVRFDSDVGEFRAVTELGRPDEEYWNSQKDILEEKRAVPDRMCRHNYELGGPMTLQRR/EKKYFAATQFRPLAA	proteinmpnn_test_binder_nonbinder/out/alignment/90p_with_pep.tsv	90p/90p
HVSTYAAFVQTHRPTGEFMFEFDEDEMFYVDLDKKETVWHLEEFGQAFSFEAQGGLANIAILNNNLNTLIQRSNHTQ/VYQLRQECYAFNGTQRFLERYIYNREEFVRFDSDVGEFRAVTELGRPDEDYWNSQKDLLEEERAVPDRMCRHNYELDEAVTLQRR/ESKYFAATQFEPLAA	proteinmpnn_test_binder_nonbinder/out/alignment/91p_with_pep.tsv	91p/91p
HVSTYAAFVQTHRPTGEFMFEFDEDEMFYVDLDKKETVWHLEEFGQAFSFEAQGGLANIAILNNNLNTLIQRSNHTQ/VYQLRQECYAFNGTQRFLERYIYNREEFVRFDSDVGEFRAVTELGRPDEDYWNSQKDLLEEKRAVPDRVCRHNYELDEAVTLQRR/ERSLWIIFSKNLNIK	proteinmpnn_test_binder_nonbinder/out/alignment/92p_with_pep.tsv	92p/92p
DHVASYGVNLYQSYGPSGQYTHEFDGDEQFYVDLGRKETVWCLPVLRQFRFDPQFALTNIAVTKHNLNILIKRSNSTA/FVFQFKGMCYFTNGTERVRGVTRYIYNREEYARFDSDVGVYRAVTPLGRLDAEYWNSQKDILEEDRASVDTVCRHNYQLELRTTLQRR/EEDIEIIKIQEEEY	proteinmpnn_test_binder_nonbinder/out/alignment/93p_with_pep.tsv	93p/93p
DHVASYGVNLYQSYGPSGQYTHEFDGDEQFYVDLGRKETVWCLPVLRQFRFDPQFALTNIAVLKHNLNSLIKRSNSTA/FVYQFKAMCYFTNGTERVRYVTRYIYNREEYARFDSDVEVYRAVTPLGPPDAEYWNSQKEVLERTRAELDTVCRHNYQLELRTTLQRR/EQKLIEKINAGFKAALAAAA	proteinmpnn_test_binder_nonbinder/out/alignment/94p_with_pep.tsv	94p/94p
DHVASCGVNLYQFYGPSGQYTHEFDGDEQFYVDLERKETAWRWPEFSKFGGFDPQGALRNMAVAKHNLNIMIKRYNSTA/FVFQFKGMCYFTNGTERVRLVTRYIYNREEYARFDSDVGVYRAVTPQGRPDAEYWNSQKEVLEGTRAELDTVCRHNYEVAFRGILQRR/AATTAGTTVYGAFAA	proteinmpnn_test_binder_nonbinder/out/alignment/95p_with_pep.tsv	95p/95p
HVSTYAMFVQTHRPTGEFMFEFDEDEMFYVDLDKKETVWHLEEFGQAFSFEAQGGLANIAISNNNLNTLIQRSNHTQ/LFQGRQECYAFNGTQRFLERYIYNREEFVRFDSDVGEFRAVTELGRPDEEYWNSQKDILEEKRAVPDRMCRHNYELGGPMTLQRR/EKKYFAATTFEPLAA	proteinmpnn_test_binder_nonbinder/out/alignment/96p_with_pep.tsv	96p/96p
HVSTYAAFVQTHRPTGEFMFEFDEDEMFYVDLDKKETVWHLEEFGQAFSFEAQGGLANIAILNNNLNTLIQRSNHTQ/LFQGRQECYAFNGTQRFLERYIYNREEFARFDSDVGEFRAVTELGRPAAEYWNSQKDILEEKRAVPDRMCRHNYELGGPMTLQRR/EKKYFAATQFEPLHA	proteinmpnn_test_binder_nonbinder/out/alignment/97p_with_pep.tsv	97p/97p
HVSTYAAFVQTHRPTGEFMFEFDEDEQFYVDLDKKETVWHLEEFGRAFSFEAQGGLANIAILNNNLNTLIQRSNHTQ/LFQGRQECYAFNGTQRFLERYIYNREELVRFDSDVGEFRAVTELGRPEAEYWNSQKDILEEKRAVPDRMCRHNYELDEAVTLQRR/APEVKYTVFKTALKK	proteinmpnn_test_binder_nonbinder/out/alignment/98p_with_pep.tsv	98p/98p
DHVASCGVNLYQFYGPSGQYTHEFDGDEQFYVDLERKETAWRWPEFSKFGGFDPQGALRNMAVAKHNLNIMIKRYNSTA/FVYQFKGLCYFTNGTERVRGVTRHIYNREEYVRFDSDVGVYRAVTPQGRPVAEYWNSQKEVLEGARASVDRVCRHNYEVAYRGILQRR/LRTLVLAPTRVVLSE	proteinmpnn_test_binder_nonbinder/out/alignment/100p_with_pep.tsv	100p/100p
HVSTYAAFVQTHRPTGEFMFEFDEDEMFYVDLDKKETVWHLEEFGQAFSFEAQGGLANIAILNNNLNTLIQRSNHTQ/LFQGRQECYAFNGTQRFLERYIYNREEFARFDSDVGEFRAVTELGRPAAEYWNSQKDILEEKRAVPDRMCRHNYELGGPMTLQRR/AETCPIFYDVFFAVA	proteinmpnn_test_binder_nonbinder/out/alignment/99p_with_pep.tsv	99p/99p
HVSTYAAFVQTHRPTGEFMFEFDEDEQFYVDLDKKETVWHLEEFGRAFSFEAQGGLANIAILNNNLNTLIQRSNHTQ/VYQGRQECYAFNGTQRFLERYIYNREEYARFDSDVGEFRAVTELGRPAAEYWNSQKDILEEKRAVPDRVCRHNYELDEAVTLQRR/EKKYFWATQFEPLAA	proteinmpnn_test_binder_nonbinder/out/alignment/101p_with_pep.tsv	101p/101p
HVSTYAAFVQTHRPTGEFMFEFDEDEQFYVDLDKKETVWHLEEFGRAFSFEAQGGLANIAILNNNLNTLIQRSNHTQ/VHQLRQECYAFNGTQRFLERYIYNREEFVRFDSDVGEFRAVTELGRPDEDYWNSQKDLLEEKRAVPDRVCRHNYELDEAVTLQRR/EKKYFAATQFEPLAF	proteinmpnn_test_binder_nonbinder/out/alignment/102p_with_pep.tsv	102p/102p
HVSTYAAFVQTHRPTGEFMFEFDEDEMFYVDLDKKETVWHLEEFGQAFSFEAQGGLANIAILNNNLNTLIQRSNHTQ/VYQLRQECYAFNGTQRFLERYIYNREEFVRFDSDVGEFRAVTELGRPDEDYWNSQKDLLEEERAVPDRMCRHNYELDEAVTLQRR/EKKYFAAYQFEPLAA	proteinmpnn_test_binder_nonbinder/out/alignment/104p_with_pep.tsv	104p/104p
DHVASYGVNLYQSYGPSGQYTHEFDGDEQFYVDLGRKETVWCLPVLRQFRFDPQFALTNIAVLKHNLNSLIKRSNSTA/FVYQFKAMCYFTNGTERVRYVTRYIYNREEYARFDSDVEVYRAVTPLGPPDAEYWNSQKEVLERTRAELDTVCRHNYQLELRTTLQRR/LEAAVKQAYAATVAT	proteinmpnn_test_binder_nonbinder/out/alignment/103p_with_pep.tsv	103p/103p
HVSTYAAFVQTHRPTGEFMFEFDEDEQFYVDLDKKETVWHLEEFGRAFSFEAQGGLANIAILNNNLNTLIQRSNHTQ/VYQGRQECYAFNGTQRFLERYIYNREEYARFDSDVGEFRAVTELGRPAAEYWNSQKDILEEKRAVPDRVCRHNYELDEAVTLQRR/GKKYFAATQFEPLAA	proteinmpnn_test_binder_nonbinder/out/alignment/105p_with_pep.tsv	105p/105p
HVSTYAAFVQTHRPTGEFMFEFDEDEMFYVDLDKKETVWHLEEFGQAFSFEAQGGLANIAILNNNLNTLIQRSNHTQ/VYQLRQECYAFNGTQRFLERYIYNREEFVRFDSDVGEFRAVTELGRPDEDYWNSQKDLLEEERAVPDRMCRHNYELDEAVTLQRR/EKKCFAATQFEPLAA	proteinmpnn_test_binder_nonbinder/out/alignment/107p_with_pep.tsv	107p/107p
DHVASCGVNLYQFYGPSGQYTHEFDGDEQFYVDLERKETAWRWPEFSKFGGFDPQGALRNMAVAKHNLNIMIKRYNSTA/FVFQFKGMCYFTNGTERVRLVTRYIYNREEYARFDSDVGVYRAVTPQGRPDAEYWNSQKEVLEGTRAELDTVCRHNYEVAFRGILQRR/YAATAGTTVYGAFAA	proteinmpnn_test_binder_nonbinder/out/alignment/106p_with_pep.tsv	106p/106p
HVSTYAAFVQTHRPTGEFMFEFDEDEMFYVDLDKKETVWHLEEFGQAFSFEAQGGLANIAILNNNLNTLIQRSNHTQ/LFQGRQECYAFNGTQRFLERYIYNREEFARFDSDVGEFRAVTELGRPAAEYWNSQKDILEEKRAVPDRMCRHNYELGGPMTLQRR/EKKYFAATQFEPLAW	proteinmpnn_test_binder_nonbinder/out/alignment/108p_with_pep.tsv	108p/108p
HVSTYAAFVQTHRPTGEFMFEFDEDEMFYVDLDKKETVWHLEEFGQAFSFEAQGGLANIAILNNNLNTLIQRSNHTQ/LFQGRQECYAFNGTQRFLERYIYNREEFARFDSDVGEFRAVTELGRPAAEYWNSQKDILEEKRAVPDRMCRHNYELGGPMTLQRR/EKKPFAATQFEPLAA	proteinmpnn_test_binder_nonbinder/out/alignment/109p_with_pep.tsv	109p/109p
HVSTYAMFVQTHRPTGEFMFEFDEDEMFYVDLDKKETVWHLEEFGQAFSFEAQGGLANIAISNNNLNTLIQRSNHTQ/LFQGRQECYAFNGTQRFLERYIYNREEFVRFDSDVGEFRAVTELGRPDEEYWNSQKDILEEKRAVPDRMCRHNYELGGPMTLQRR/ETKYFAATQFEPLAA	proteinmpnn_test_binder_nonbinder/out/alignment/111p_with_pep.tsv	111p/111p
HVSTYAAFVQTHRPTGEFMFEFDEDEMFYVDLDKKETVWHLEEFGQAFSFEAQGGLANIAILNNNLNTLIQRSNHTQ/LFQGRQECYAFNGTQRFLERYIYNREEFARFDSDVGEFRAVTELGRPAAEYWNSQKDILEEKRAVPDRMCRHNYELGGPMTLQRR/EKKYFAATQFEPTAA	proteinmpnn_test_binder_nonbinder/out/alignment/110p_with_pep.tsv	110p/110p
HVSTYAAFVQTHRPTGEFMFEFDEDEQFYVDLDKKETVWHLEEFGRAFSFEAQGGLANIAILNNNLNTLIQRSNHTQ/VYQGRQECYAFNGTQRFLERYIYNREEYARFDSDVGEFRAVTELGRPAAEYWNSQKDILEEKRAVPDRVCRHNYELDEAVTLQRR/EKKYFANTQFEPLAA	proteinmpnn_test_binder_nonbinder/out/alignment/112p_with_pep.tsv	112p/112p
DHVASCGVNLYQFYGPSGQYTHEFDGDEQFYVDLERKETAWRWPEFSKFGGFDPQGALRNMAVAKHNLNIMIKRYNSTA/FVFQFKGMCYFTNGTERVRLVTRYIYNREEYARFDSDVGVYRAVTPQGRPDAEYWNSQKEVLEGTRAELDTVCRHNYEVAFRGILQRR/SQPATGAATVAAGAA	proteinmpnn_test_binder_nonbinder/out/alignment/113p_with_pep.tsv	113p/113p
HVSTYAAFVQTHRPTGEFMFEFDEDEQFYVDLDKKETVWHLEEFGRAFSFEAQGGLANIAILNNNLNTLIQRSNHTQ/VYQGRQECYAFNGTQRFLERYIYNREEYARFDSDVGEFRAVTELGRPAAEYWNSQKDILEEKRAVPDRVCRHNYELDEAVTLQRR/EKKYFAATQFEPLAW	proteinmpnn_test_binder_nonbinder/out/alignment/115p_with_pep.tsv	115p/115p
DHVASYGVNLYQSYGPSGQFTHEFDGDEEFYVDLERKETVWKLPLFHRLRFDPQFALTNIAVLKHNLNILIKRSNSTA/FVFQFKGMCYFTNGTERVRGVTRYIYNREEYARFDSDVGVYRAVTPLGRLDAEYWNSQKDILEEDRASVDTVCRHNYQLELRTTLQRR/AMYMALIAAFSIRPGK	proteinmpnn_test_binder_nonbinder/out/alignment/114p_with_pep.tsv	114p/114p
HVSTYAAFVQTHRPTGEFMFEFDEDEMFYVDLDKKETVWHLEEFGQAFSFEAQGGLANIAILNNNLNTLIQRSNHTQ/VYQLRQECYAFNGTQRFLERYIYNREEFVRFDSDVGEFRAVTELGRPDEDYWNSQKDLLEEERAVPDRMCRHNYELDEAVTLQRR/EKKYFAATQFELLAA	proteinmpnn_test_binder_nonbinder/out/alignment/116p_with_pep.tsv	116p/116p
HVSTYAAFVQTHRPTGEFMFEFDEDEMFYVDLDKKETVWHLEEFGQAFSFEAQGGLANIAILNNNLNTLIQRSNHTQ/LFQGRQECYAFNGTQRFLERYIYNREEFARFDSDVGEFRAVTELGRPAAEYWNSQKDILEEKRAVPDRMCRHNYELGGPMTLQRR/EKKYFAATQFEPLAL	proteinmpnn_test_binder_nonbinder/out/alignment/117p_with_pep.tsv	117p/117p
HVSTYAAFVQTHRPTGEFMFEFDEDEQFYVDLDKKETVWHLEEFGRAFSFEAQGGLANIAILNNNLNTLIQRSNHTQ/LFQGRQECYAFNGTQRFLERYIYNREELVRFDSDVGEFRAVTELGRPEAEYWNSQKDILEEKRAVPDRMCRHNYELDEAVTLQRR/EKQYFAATQFEPLAA	proteinmpnn_test_binder_nonbinder/out/alignment/119p_with_pep.tsv	119p/119p
HVSTYAAFVQTHRPTGEFMFEFDEDEQFYVDLDKKETVWHLEEFGRAFSFEAQGGLANIAILNNNLNTLIQRSNHTQ/VYQGRQECYAFNGTQRFLERYIYNREEYARFDSDVGEFRAVTELGRPAAEYWNSQKDILEEKRAVPDRVCRHNYELDEAVTLQRR/EKKYFAASQFEPLAA	proteinmpnn_test_binder_nonbinder/out/alignment/120p_with_pep.tsv	120p/120p
DHVASYGVNLYQSYGPSGQYTHEFDGDEQFYVDLGRKETVWCLPVLRQFRFDPQFALTNIAVLKHNLNSLIKRSNSTA/FVYQFKAMCYFTNGTERVRYVTRYIYNREEYARFDSDVEVYRAVTPLGPPDAEYWNSQKEVLERTRAELDTVCRHNYQLELRTTLQRR/ELYYAIYKASPTLAF	proteinmpnn_test_binder_nonbinder/out/alignment/118p_with_pep.tsv	118p/118p
HVSTYAAFVQTHRPTGEFMFEFDEDEQFYVDLDKKETVWHLEEFGRAFSFEAQGGLANIAILNNNLNTLIQRSNHTQ/LFQGRQECYAFNGTQRFLERYIYNREELVRFDSDVGEFRAVTELGRPEAEYWNSQKDILEEKRAVPDRMCRHNYELDEAVTLQRR/GETLLRAVESYLLAH	proteinmpnn_test_binder_nonbinder/out/alignment/121p_with_pep.tsv	121p/121p
HVSTYAAFVQTHRPTGEFMFEFDEDEQFYVDLDKKETVWHLEEFGRAFSFEAQGGLANIAILNNNLNTLIQRSNHTQ/VYQGRQECYAFNGTQRFLERYIYNREEYARFDSDVGEFRAVTELGRPAAEYWNSQKDILEEKRAVPDRVCRHNYELDEAVTLQRR/EKKYFAATQFEPLDA	proteinmpnn_test_binder_nonbinder/out/alignment/122p_with_pep.tsv	122p/122p
DHVASYGVNLYQSYGPSGQYTHEFDGDEQFYVDLGRKETVWCLPVLRQFRFDPQFALTNIAVLKHNLNSLIKRSNSTA/FVYQFKAMCYFTNGTERVRYVTRYIYNREEYARFDSDVEVYRAVTPLGPPDAEYWNSQKEVLERTRAELDTVCRHNYQLELRTTLQRR/RDCLIAHGAANTITE	proteinmpnn_test_binder_nonbinder/out/alignment/124p_with_pep.tsv	124p/124p
DHVASCGVNLYQFYGPSGQYTHEFDGDEQFYVDLERKETAWRWPEFSKFGGFDPQGALRNMAVAKHNLNIMIKRYNSTA/FVFQFKGMCYFTNGTERVRLVTRYIYNREEYARFDSDVGVYRAVTPQGRPDAEYWNSQKEVLEGTRAELDTVCRHNYEVAFRGILQRR/ASIIRLVGAVLAEQH	proteinmpnn_test_binder_nonbinder/out/alignment/123p_with_pep.tsv	123p/123p
HVSTYAMFVQTHRPTGEFMFEFDEDEMFYVDLDKKETVWHLEEFGQAFSFEAQGGLANIAISNNNLNTLIQRSNHTQ/LFQGRQECYAFNGTQRFLERYIYNREEFVRFDSDVGEFRAVTELGRPDEEYWNSQKDILEEKRAVPDRMCRHNYELGGPMTLQRR/MLFRILSLNLIKIK	proteinmpnn_test_binder_nonbinder/out/alignment/125p_with_pep.tsv	125p/125p
HVSTYAAFVQTHRPTGEFMFEFDEDEMFYVDLDKKETVWHLEEFGQAFSFEAQGGLANIAILNNNLNTLIQRSNHTQ/VYQLRQECYAFNGTQRFLERYIYNREEFVRFDSDVGEFRAVTELGRPDEDYWNSQKDLLEEERAVPDRMCRHNYELDEAVTLQRR/EKKYFAATGFEPLAA	proteinmpnn_test_binder_nonbinder/out/alignment/126p_with_pep.tsv	126p/126p
HVSTYAAFVQTHRPTGEFMFEFDEDEQFYVDLDKKETVWHLEEFGRAFSFEAQGGLANIAILNNNLNTLIQRSNHTQ/VYQGRQECYAFNGTQRFLERYIYNREEYARFDSDVGEFRAVTELGRPAAEYWNSQKDILEEKRAVPDRVCRHNYELDEAVTLQRR/EKKYFAATCFEPLAA	proteinmpnn_test_binder_nonbinder/out/alignment/128p_with_pep.tsv	128p/128p
HVSTYAAFVQTHRPTGEFMFEFDEDEQFYVDLDKKETVWHLEEFGRAFSFEAQGGLANIAILNNNLNTLIQRSNHTQ/VHQLRQECYAFNGTQRFLERYIYNREEFVRFDSDVGEFRAVTELGRPDEDYWNSQKDLLEEKRAVPDRVCRHNYELDEAVTLQRR/AFKVAATAANAARAN	proteinmpnn_test_binder_nonbinder/out/alignment/127p_with_pep.tsv	127p/127p
HVSTYAAFVQTHRPTGEFMFEFDEDEMFYVDLDKKETVWHLEEFGQAFSFEAQGGLANIAILNNNLNTLIQRSNHTQ/VYQLRQECYAFNGTQRFLERYIYNREEFVRFDSDVGEFRAVTELGRPDEDYWNSQKDLLEEKRAVPDRVCRHNYELDEAVTLQRR/AFKIAATAANAAPTN	proteinmpnn_test_binder_nonbinder/out/alignment/129p_with_pep.tsv	129p/129p
DHVASYGVNLYQSYGPSGQYTHEFDGDEQFYVDLGRKETVWCLPVLRQFRFDPQFALTNIAVLKHNLNSLIKRSNSTA/FVYQFKAMCYFTNGTERVRYVTRYIYNREEYARFDSDVEVYRAVTPLGPPDAEYWNSQKEVLERTRAELDTVCRHNYQLELRTTLQRR/YQNPTTYISVGTSTLNQ	proteinmpnn_test_binder_nonbinder/out/alignment/130p_with_pep.tsv	130p/130p
HVSTYAAFVQTHRPTGEFMFEFDEDEQFYVDLDKKETVWHLEEFGRAFSFEAQGGLANIAILNNNLNTLIQRSNHTQ/VYQGRQECYAFNGTQRFLERYIYNREEYARFDSDVGEFRAVTELGRPAAEYWNSQKDILEEKRAVPDRVCRHNYELDEAVTLQRR/YKKYFAATQFEPLAA	proteinmpnn_test_binder_nonbinder/out/alignment/132p_with_pep.tsv	132p/132p
HVSTYAAFVQTHRPTGEFMFEFDEDEMFYVDLDKKETVWHLEEFGQAFSFEAQGGLANIAILNNNLNTLIQRSNHTQ/VYQLRQECYAFNGTQRFLERYIYNREEFVRFDSDVGEFRAVTELGRPDEDYWNSQKDLLEEERAVPDRMCRHNYELDEAVTLQRR/EKKWFAATQFEPLAA	proteinmpnn_test_binder_nonbinder/out/alignment/131p_with_pep.tsv	131p/131p
HVSTYAAFVQTHRPTGEFMFEFDEDEMFYVDLDKKETVWHLEEFGQAFSFEAQGGLANIAILNNNLNTLIQRSNHTQ/VYQLRQECYAFNGTQRFLERYIYNREEFVRFDSDVGEFRAVTELGRPDEDYWNSQKDLLEEKRAVPDRVCRHNYELDEAVTLQRR/DYVRMWVQAATAMSA	proteinmpnn_test_binder_nonbinder/out/alignment/133p_with_pep.tsv	133p/133p
HVSTYAMFVQTHRPTGEFMFEFDEDEMFYVDLDKKETVWHLEEFGQAFSFEAQGGLANIAISNNNLNTLIQRSNHTQ/LFQGRQECYAFNGTQRFLERYIYNREEFVRFDSDVGEFRAVTELGRPDEEYWNSQKDILEEKRAVPDRMCRHNYELGGPMTLQRR/EKKYFALTQFEPLAA	proteinmpnn_test_binder_nonbinder/out/alignment/134p_with_pep.tsv	134p/134p
HVSTYAAFVQTHRPTGEFMFEFDEDEMFYVDLDKKETVWHLEEFGQAFSFEAQGGLANIAILNNNLNTLIQRSNHTQ/LFQGRQECYAFNGTQRFLERYIYNREEFARFDSDVGEFRAVTELGRPAAEYWNSQKDILEEKRAVPDRMCRHNYELGGPMTLQRR/EKYYFAATQFEPLAA	proteinmpnn_test_binder_nonbinder/out/alignment/136p_with_pep.tsv	136p/136p
HVSTYAMFVQTHRPTGEFMFEFDEDEMFYVDLDKKETVWHLEEFGQAFSFEAQGGLANIAISNNNLNTLIQRSNHTQ/LFQGRQECYAFNGTQRFLERYIYNREEFVRFDSDVGEFRAVTELGRPDEEYWNSQKDILEEKRAVPDRMCRHNYELGGPMTLQRR/EKKYFAATSFEPLAA	proteinmpnn_test_binder_nonbinder/out/alignment/135p_with_pep.tsv	135p/135p
HVSTYAAFVQTHRPTGEFMFEFDEDEQFYVDLDKKETVWHLEEFGRAFSFEAQGGLANIAILNNNLNTLIQRSNHTQ/LFQGRQECYAFNGTQRFLERYIYNREELVRFDSDVGEFRAVTELGRPEAEYWNSQKDILEEKRAVPDRMCRHNYELDEAVTLQRR/EKFYFAATQFEPLAA	proteinmpnn_test_binder_nonbinder/out/alignment/137p_with_pep.tsv	137p/137p
HVSTYAAFVQTHRPTGEFMFEFDEDEMFYVDLDKKETVWHLEEFGQAFSFEAQGGLANIAILNNNLNTLIQRSNHTQ/VYQLRQECYAFNGTQRFLERYIYNREEFVRFDSDVGEFRAVTELGRPDEDYWNSQKDLLEEERAVPDRMCRHNYELDEAVTLQRR/EKKYFAATQFEPLYA	proteinmpnn_test_binder_nonbinder/out/alignment/138p_with_pep.tsv	138p/138p
HVSTYAAFVQTHRPTGEFMFEFDEDEMFYVDLDKKETVWHLEEFGQAFSFEAQGGLANIAILNNNLNTLIQRSNHTQ/VYQLRQECYAFNGTQRFLERYIYNREEFVRFDSDVGEFRAVTELGRPDEDYWNSQKDLLEEERAVPDRMCRHNYELDEAVTLQRR/EKKYFAATVFEPLAA	proteinmpnn_test_binder_nonbinder/out/alignment/140p_with_pep.tsv	140p/140p
DHVASCGVNLYQFYGPSGQYTHEFDGDEQFYVDLERKETAWRWPEFSKFGGFDPQGALRNMAVAKHNLNIMIKRYNSTA/FVFQFKGMCYFTNGTERVRLVTRYIYNREEYARFDSDVGVYRAVTPQGRPDAEYWNSQKEVLEGTRAELDTVCRHNYEVAFRGILQRR/AAAEAGTTVYGAFAA	proteinmpnn_test_binder_nonbinder/out/alignment/139p_with_pep.tsv	139p/139p
DHVASCGVNLYQFYGPSGQYTHEFDGDEEFYVDLERKETAWRWPEFSKFGGFDPQGALRNMAVAKHNLNIMIKRYNSTA/FVYQFKGLCYFTNGTERVRGVTRHIYNREEYVRFDSDVGVYRAVTPQGRPVAEYWNSQKEVLEGARASVDRVCRHNYEVAYRGILQRR/SQDLELSWNLNVLQAY	proteinmpnn_test_binder_nonbinder/out/alignment/141p_with_pep.tsv	141p/141p
DHVASYGVNLYQSYGPSGQYTHEFDGDEQFYVDLGRKETVWCLPVLRQFRFDPQFALTNIAVLKHNLNSLIKRSNSTA/FVFQFKGMCYFTNGTERVRGVTRYIYNREEYARFDSDVGVYRAVTPLGRLDAEYWNSQKDILEEDRASVDTVCRHNYQLELRTTLQRR/YPMEIRPRKTHESHL	proteinmpnn_test_binder_nonbinder/out/alignment/142p_with_pep.tsv	142p/142p
DHVASCGVNLYQFYGPSGQYTHEFDGDEQFYVDLERKETAWRWPEFSKFGGFDPQGALRNMAVAKHNLNIMIKRYNSTA/FVFQFKGMCYFTNGTERVRLVTRYIYNREEYARFDSDVGVYRAVTPQGRPDAEYWNSQKEVLEGTRAELDTVCRHNYEVAFRGILQRR/AAATAGTTVYGAFAL	proteinmpnn_test_binder_nonbinder/out/alignment/144p_with_pep.tsv	144p/144p
DHVASCGVNLYQFYGPSGQYTHEFDGDEQFYVDLERKETAWRWPEFSKFGGFDPQGALRNMAVAKHNLNIMIKRYNSTA/FVFQFKGMCYFTNGTERVRLVTRYIYNREEYARFDSDVGVYRAVTPQGRPDAEYWNSQKEVLEGTRAELDTVCRHNYEVAFRGILQRR/AMATAGTTVYGAFAA	proteinmpnn_test_binder_nonbinder/out/alignment/143p_with_pep.tsv	143p/143p
HVSTYAAFVQTHRPTGEFMFEFDEDEQFYVDLDKKETVWHLEEFGRAFSFEAQGGLANIAILNNNLNTLIQRSNHTQ/VHQLRQECYAFNGTQRFLERYIYNREEFVRFDSDVGEFRAVTELGRPDEDYWNSQKDLLEEKRAVPDRVCRHNYELDEAVTLQRR/EKKYFAATQFEPLAA	proteinmpnn_test_binder_nonbinder/out/alignment/145p_with_pep.tsv	145p/145p
HVSTYAAFVQTHRPTGEFMFEFDEDEMFYVDLDKKETVWHLEEFGQAFSFEAQGGLANIAILNNNLNTLIQRSNHTQ/VYQLRQECYAFNGTQRFLERYIYNREEFVRFDSDVGEFRAVTELGRPDEDYWNSQKDLLEEKRAVPDRVCRHNYELDEAVTLQRR/QVYPRSWSAVMLTFD	proteinmpnn_test_binder_nonbinder/out/alignment/146p_with_pep.tsv	146p/146p
HVSTYAMFVQTHRPTGEFMFEFDEDEMFYVDLDKKETVWHLEEFGQAFSFEAQGGLANIAISNNNLNTLIQRSNHTQ/LFQGRQECYAFNGTQRFLERYIYNREEFVRFDSDVGEFRAVTELGRPDEEYWNSQKDILEEKRAVPDRMCRHNYELGGPMTLQRR/EKKYFAAQQFEPLAA	proteinmpnn_test_binder_nonbinder/out/alignment/147p_with_pep.tsv	147p/147p
DHVASYGVNLYQSYGPSGQYTHEFDGDEQFYVDLGRKETVWCLPVLRQFRFDPQFALTNIAVLKHNLNSLIKRSNSTA/FVYQFKAMCYFTNGTERVRYVTRYIYNREEYARFDSDVEVYRAVTPLGPPDAEYWNSQKEVLERTRAELDTVCRHNYQLELRTTLQRR/SVAYKAAVGATPEAK	proteinmpnn_test_binder_nonbinder/out/alignment/148p_with_pep.tsv	148p/148p
EADHVGFYGTTVYQSPGDIGQYTHEFDGDELFYVDLDKKKTVWRLPEFGQLILFEPQGGLQNIAAEKHNLGILTKRSNFTPA/HFVVQFKGECYYTNGTQRIRLVTRYIYNREEYVRYDSDVGEYRAVTELGRPDAEYWNSQPEILDRTRAEVDTACRHNYEGPETSTSLRR/AHAAHAAHAAHAAHAA	proteinmpnn_test_binder_nonbinder/out/alignment/149p_with_pep.tsv	149p/149p
HVSTYAMFVQTHRPTGEFMFEFDEDEMFYVDLDKKETVWHLEEFGQAFSFEAQGGLANIAISNNNLNTLIQRSNHTQ/LFQGRQECYAFNGTQRFLERYIYNREEFVRFDSDVGEFRAVTELGRPDEEYWNSQKDILEEKRAVPDRMCRHNYELGGPMTLQRR/EKYYFAATQFEPLAA	proteinmpnn_test_binder_nonbinder/out/alignment/151p_with_pep.tsv	151p/151p
HVSTYAAFVQTHRPTGEFMFEFDEDEMFYVDLDKKETVWHLEEFGQAFSFEAQGGLANIAILNNNLNTLIQRSNHTQ/VYQLRQECYAFNGTQRFLERYIYNREEFVRFDSDVGEFRAVTELGRPDEDYWNSQKDLLEEERAVPDRMCRHNYELDEAVTLQRR/EKKYFAATQFEALAA	proteinmpnn_test_binder_nonbinder/out/alignment/150p_with_pep.tsv	150p/150p
HVSTYAAFVQTHRPTGEFMFEFDEDEQFYVDLDKKETVWHLEEFGRAFSFEAQGGLANIAILNNNLNTLIQRSNHTQ/LFQGRQECYAFNGTQRFLERYIYNREELVRFDSDVGEFRAVTELGRPEAEYWNSQKDILEEKRAVPDRMCRHNYELDEAVTLQRR/DSYKFIPTLVAAVKQ	proteinmpnn_test_binder_nonbinder/out/alignment/152p_with_pep.tsv	152p/152p
HVSTYAAFVQTHRPTGEFMFEFDEDEQFYVDLDKKETVWHLEEFGRAFSFEAQGGLANIAILNNNLNTLIQRSNHTQ/VYQGRQECYAFNGTQRFLERYIYNREEYARFDSDVGEFRAVTELGRPAAEYWNSQKDILEEKRAVPDRVCRHNYELDEAVTLQRR/WKKYFAATQFEPLAA	proteinmpnn_test_binder_nonbinder/out/alignment/153p_with_pep.tsv	153p/153p
HVSTYAMFVQTHRPTGEFMFEFDEDEMFYVDLDKKETVWHLEEFGQAFSFEAQGGLANIAISNNNLNTLIQRSNHTQ/LFQGRQECYAFNGTQRFLERYIYNREEFVRFDSDVGEFRAVTELGRPDEEYWNSQKDILEEKRAVPDRMCRHNYELGGPMTLQRR/EKKYFSATQFEPLAA	proteinmpnn_test_binder_nonbinder/out/alignment/155p_with_pep.tsv	155p/155p
HVSTYAAFVQTHRPTGEFMFEFDEDEMFYVDLDKKETVWHLEEFGQAFSFEAQGGLANIAILNNNLNTLIQRSNHTQ/LFQGRQECYAFNGTQRFLERYIYNREEFARFDSDVGEFRAVTELGRPAAEYWNSQKDILEEKRAVPDRMCRHNYELGGPMTLQRR/EKKEFAATQFEPLAA	proteinmpnn_test_binder_nonbinder/out/alignment/154p_with_pep.tsv	154p/154p
HVSTYAAFVQTHRPTGEFMFEFDEDEQFYVDLDKKETVWHLEEFGRAFSFEAQGGLANIAILNNNLNTLIQRSNHTQ/VYQGRQECYAFNGTQRFLERYIYNREEYARFDSDVGEFRAVTELGRPAAEYWNSQKDILEEKRAVPDRVCRHNYELDEAVTLQRR/EKKYFAATQFESLAA	proteinmpnn_test_binder_nonbinder/out/alignment/156p_with_pep.tsv	156p/156p
HVSTYAAFVQTHRPTGEFMFEFDEDEMFYVDLDKKETVWHLEEFGQAFSFEAQGGLANIAILNNNLNTLIQRSNHTQ/LFQGRQECYAFNGTQRFLERYIYNREEFARFDSDVGEFRAVTELGRPAAEYWNSQKDILEEKRAVPDRMCRHNYELGGPMTLQRR/EKKYFAATQFEPSAA	proteinmpnn_test_binder_nonbinder/out/alignment/157p_with_pep.tsv	157p/157p
HVSTYAAFVQTHRPTGEFMFEFDEDEMFYVDLDKKETVWHLEEFGQAFSFEAQGGLANIAILNNNLNTLIQRSNHTQ/VYQLRQECYAFNGTQRFLERYIYNREEFVRFDSDVGEFRAVTELGRPDEDYWNSQKDLLEEERAVPDRMCRHNYELDEAVTLQRR/EKKTFAATQFEPLAA	proteinmpnn_test_binder_nonbinder/out/alignment/159p_with_pep.tsv	159p/159p
HVSTYAAFVQTHRPTGEFMFEFDEDEMFYVDLDKKETVWHLEEFGQAFSFEAQGGLANIAILNNNLNTLIQRSNHTQ/VYQLRQECYAFNGTQRFLERYIYNREEFVRFDSDVGEFRAVTELGRPDEDYWNSQKDLLEEKRAVPDRVCRHNYELDEAVTLQRR/AFKVAITAANAAPAN	proteinmpnn_test_binder_nonbinder/out/alignment/158p_with_pep.tsv	158p/158p
HVSTYAAFVQTHRPTGEFMFEFDEDEQFYVDLDKKETVWHLEEFGRAFSFEAQGGLANIAILNNNLNTLIQRSNHTQ/VYQGRQECYAFNGTQRFLERYIYNREEYARFDSDVGEFRAVTELGRPAAEYWNSQKDILEEKRAVPDRVCRHNYELDEAVTLQRR/EKKYFRATQFEPLAA	proteinmpnn_test_binder_nonbinder/out/alignment/160p_with_pep.tsv	160p/160p
DHVASCGVNLYQFYGPSGQYTHEFDGDEQFYVDLERKETAWRWPEFSKFGGFDPQGALRNMAVAKHNLNIMIKRYNSTA/FVFQFKGMCYFTNGTERVRLVTRYIYNREEYARFDSDVGVYRAVTPQGRPDAEYWNSQKEVLEGTRAELDTVCRHNYEVAFRGILQRR/AWMSAAATQAEQAAT	proteinmpnn_test_binder_nonbinder/out/alignment/161p_with_pep.tsv	161p/161p
HVSTYAAFVQTHRPTGEFMFEFDEDEMFYVDLDKKETVWHLEEFGQAFSFEAQGGLANIAILNNNLNTLIQRSNHTQ/LFQGRQECYAFNGTQRFLERYIYNREEFARFDSDVGEFRAVTELGRPAAEYWNSQKDILEEKRAVPDRMCRHNYELGGPMTLQRR/GGTEIKYNGEEYLIL	proteinmpnn_test_binder_nonbinder/out/alignment/163p_with_pep.tsv	163p/163p
HVSTYAAFVQTHRPTGEFMFEFDEDEQFYVDLDKKETVWHLEEFGRAFSFEAQGGLANIAILNNNLNTLIQRSNHTQ/VHQLRQECYAFNGTQRFLERYIYNREEFVRFDSDVGEFRAVTELGRPDEDYWNSQKDLLEEKRAVPDRVCRHNYELDEAVTLQRR/FKVAATAAATAPADDKFTVF	proteinmpnn_test_binder_nonbinder/out/alignment/162p_with_pep.tsv	162p/162p
HVSTYAAFVQTHRPTGEFMFEFDEDEMFYVDLDKKETVWHLEEFGQAFSFEAQGGLANIAILNNNLNTLIQRSNHTQ/VYQLRQECYAFNGTQRFLERYIYNREEFVRFDSDVGEFRAVTELGRPDEDYWNSQKDLLEEERAVPDRMCRHNYELDEAVTLQRR/EKKHFAATQFEPLAA	proteinmpnn_test_binder_nonbinder/out/alignment/164p_with_pep.tsv	164p/164p
DHVASYGVNLYQSYGPSGQYTHEFDGDEQFYVDLGRKETVWCLPVLRQFRFDPQFALTNIAVLKHNLNSLIKRSNSTA/FVYQFKAMCYFTNGTERVRYVTRYIYNREEYARFDSDVEVYRAVTPLGPPDAEYWNSQKEVLERTRAELDTVCRHNYQLELRTTLQRR/QGQWRGAAGTAAQAA	proteinmpnn_test_binder_nonbinder/out/alignment/165p_with_pep.tsv	165p/165p
HVSTYAAFVQTHRPTGEFMFEFDEDEMFYVDLDKKETVWHLEEFGQAFSFEAQGGLANIAILNNNLNTLIQRSNHTQ/VYQLRQECYAFNGTQRFLERYIYNREEFVRFDSDVGEFRAVTELGRPDEDYWNSQKDLLEEERAVPDRMCRHNYELDEAVTLQRR/AKKYFAATQFEPLAA	proteinmpnn_test_binder_nonbinder/out/alignment/167p_with_pep.tsv	167p/167p
HVSTYAAFVQTHRPTGEFMFEFDEDEQFYVDLDKKETVWHLEEFGRAFSFEAQGGLANIAILNNNLNTLIQRSNHTQ/VYQGRQECYAFNGTQRFLERYIYNREEYARFDSDVGEFRAVTELGRPAAEYWNSQKDILEEKRAVPDRVCRHNYELDEAVTLQRR/APEVKYTVFETALKK	proteinmpnn_test_binder_nonbinder/out/alignment/166p_with_pep.tsv	166p/166p
HVSTYAAFVQTHRPTGEFMFEFDEDEMFYVDLDKKETVWHLEEFGQAFSFEAQGGLANIAILNNNLNTLIQRSNHTQ/LFQGRQECYAFNGTQRFLERYIYNREEFARFDSDVGEFRAVTELGRPAAEYWNSQKDILEEKRAVPDRMCRHNYELGGPMTLQRR/EKKYFASTQFEPLAA	proteinmpnn_test_binder_nonbinder/out/alignment/168p_with_pep.tsv	168p/168p
HVSTYAAFVQTHRPTGEFMFEFDEDEQFYVDLDKKETVWHLEEFGRAFSFEAQGGLANIAILNNNLNTLIQRSNHTQ/VYQGRQECYAFNGTQRFLERYIYNREEYARFDSDVGEFRAVTELGRPAAEYWNSQKDILEEKRAVPDRVCRHNYELDEAVTLQRR/EKKYFAATQFIPLAA	proteinmpnn_test_binder_nonbinder/out/alignment/169p_with_pep.tsv	169p/169p
HVSTYAAFVQTHRPTGEFMFEFDEDEQFYVDLDKKETVWHLEEFGRAFSFEAQGGLANIAILNNNLNTLIQRSNHTQ/VHQLRQECYAFNGTQRFLERYIYNREEFVRFDSDVGEFRAVTELGRPDEDYWNSQKDLLEEKRAVPDRVCRHNYELDEAVTLQRR/EKKYFAATQFCPLAA	proteinmpnn_test_binder_nonbinder/out/alignment/171p_with_pep.tsv	171p/171p
DHVASYGVNLYQSYGPSGQYTHEFDGDEQFYVDLGRKETVWCLPVLRQFRFDPQFALTNIAVLKHNLNSLIKRSNSTA/FVYQFKAMCYFTNGTERVRYVTRYIYNREEYARFDSDVEVYRAVTPLGPPDAEYWNSQKEVLERTRAELDTVCRHNYQLELRTTLQRR/INEPTAAAIAYGLDF	proteinmpnn_test_binder_nonbinder/out/alignment/170p_with_pep.tsv	170p/170p
HVSTYAAFVQTHRPTGEFMFEFDEDEMFYVDLDKKETVWHLEEFGQAFSFEAQGGLANIAILNNNLNTLIQRSNHTQ/VYQLRQECYAFNGTQRFLERYIYNREEFVRFDSDVGEFRAVTELGRPDEDYWNSQKDLLEEERAVPDRMCRHNYELDEAVTLQRR/EKKYFAATQFEELAA	proteinmpnn_test_binder_nonbinder/out/alignment/172p_with_pep.tsv	172p/172p
HVSTYAAFVQTHRPTGEFMFEFDEDEQFYVDLDKKETVWHLEEFGRAFSFEAQGGLANIAILNNNLNTLIQRSNHTQ/VYQGRQECYAFNGTQRFLERYIYNREEYARFDSDVGEFRAVTELGRPAAEYWNSQKDILEEKRAVPDRVCRHNYELDEAVTLQRR/EKKYFAATQFEVLAA	proteinmpnn_test_binder_nonbinder/out/alignment/173p_with_pep.tsv	173p/173p
HVSTYAAFVQTHRPTGEFMFEFDEDEMFYVDLDKKETVWHLEEFGQAFSFEAQGGLANIAILNNNLNTLIQRSNHTQ/VYQLRQECYAFNGTQRFLERYIYNREEFVRFDSDVGEFRAVTELGRPDEDYWNSQKDLLEEKRAVPDRVCRHNYELDEAVTLQRR/AFKVAATAANNAPAN	proteinmpnn_test_binder_nonbinder/out/alignment/175p_with_pep.tsv	175p/175p
HVSTYAMFVQTHRPTGEFMFEFDEDEMFYVDLDKKETVWHLEEFGQAFSFEAQGGLANIAISNNNLNTLIQRSNHTQ/LFQGRQECYAFNGTQRFLERYIYNREEFVRFDSDVGEFRAVTELGRPDEEYWNSQKDILEEKRAVPDRMCRHNYELGGPMTLQRR/EKKYFAATQFEPLGA	proteinmpnn_test_binder_nonbinder/out/alignment/174p_with_pep.tsv	174p/174p
DHVASYGVNLYQSYGPSGQYTHEFDGDEQFYVDLGRKETVWCLPVLRQFRFDPQFALTNIAVLKHNLNSLIKRSNSTA/FVYQFKGMCYFTNGTERVRLVSRSIYNREEIVRFDSDVGEFRAVTLLGLPAAEYWNSQKDILERKRAAVDRVCRHNYQLELRTTLQRR/YEPRAPWIEQEGPEYWDQE	proteinmpnn_test_binder_nonbinder/out/alignment/176p_with_pep.tsv	176p/176p
HVSTYAAFVQTHRPTGEFMFEFDEDEMFYVDLDKKETVWHLEEFGQAFSFEAQGGLANIAILNNNLNTLIQRSNHTQ/VYQLRQECYAFNGTQRFLERYIYNREEFVRFDSDVGEFRAVTELGRPDEDYWNSQKDLLEEERAVPDRMCRHNYELDEAVTLQRR/EKKYFAATQLEPLAA	proteinmpnn_test_binder_nonbinder/out/alignment/177p_with_pep.tsv	177p/177p
DHVASCGVNLYQFYGPSGQYTHEFDGDEQFYVDLERKETAWRWPEFSKFGGFDPQGALRNMAVAKHNLNIMIKRYNSTA/FVFQFKGMCYFTNGTERVRLVTRYIYNREEYARFDSDVGVYRAVTPQGRPDAEYWNSQKEVLEGTRAELDTVCRHNYEVAFRGILQRR/INEITAAAIAYGLDR	proteinmpnn_test_binder_nonbinder/out/alignment/179p_with_pep.tsv	179p/179p
HVSTYAAFVQTHRPTGEFMFEFDEDEMFYVDLDKKETVWHLEEFGQAFSFEAQGGLANIAILNNNLNTLIQRSNHTQ/VYQLRQECYAFNGTQRFLERYIYNREEFVRFDSDVGEFRAVTELGRPDEDYWNSQKDLLEEKRAVPDRVCRHNYELDEAVTLQRR/KASTGGAYESYKFIPALEAA	proteinmpnn_test_binder_nonbinder/out/alignment/178p_with_pep.tsv	178p/178p
HVSTYAAFVQTHRPTGEFMFEFDEDEMFYVDLDKKETVWHLEEFGQAFSFEAQGGLANIAILNNNLNTLIQRSNHTQ/LFQGRQECYAFNGTQRFLERYIYNREEFARFDSDVGEFRAVTELGRPAAEYWNSQKDILEEKRAVPDRMCRHNYELGGPMTLQRR/EKKYFAAFQFEPLAA	proteinmpnn_test_binder_nonbinder/out/alignment/180p_with_pep.tsv	180p/180p
HVSTYAAFVQTHRPTGEFMFEFDEDEMFYVDLDKKETVWHLEEFGQAFSFEAQGGLANIAILNNNLNTLIQRSNHTQ/VYQLRQECYAFNGTQRFLERYIYNREEFVRFDSDVGEFRAVTELGRPDEDYWNSQKDLLEEERAVPDRMCRHNYELDEAVTLQRR/EKKYFAATYFEPLAA	proteinmpnn_test_binder_nonbinder/out/alignment/181p_with_pep.tsv	181p/181p
DHVASYGVNLYQSYGPSGQYSHEFDGDEEFYVDLERKETVWQLPLFRRFRRFDPQFALTNIAVLKHNLNIVIKRSNSTA/FVYQFKGMCYFTNGTERVRLVTRYIYNREEYARFDSDVGVYRAVTPLGPPAAEYWNSQKEVLERTRAELDTVCRHNYQLELRTTLQRR/KEDIEIIPIQEEEY	proteinmpnn_test_binder_nonbinder/out/alignment/183p_with_pep.tsv	183p/183p
HVSTYAAFVQTHRPTGEFMFEFDEDEMFYVDLDKKETVWHLEEFGQAFSFEAQGGLANIAILNNNLNTLIQRSNHTQ/VYQLRQECYAFNGTQRFLERYIYNREEFVRFDSDVGEFRAVTELGRPDEDYWNSQKDLLEEERAVPDRMCRHNYELDEAVTLQRR/EKKYSAATQFEPLAA	proteinmpnn_test_binder_nonbinder/out/alignment/182p_with_pep.tsv	182p/182p
HVSTYAAFVQTHRPTGEFMFEFDEDEMFYVDLDKKETVWHLEEFGQAFSFEAQGGLANIAILNNNLNTLIQRSNHTQ/VYQLRQECYAFNGTQRFLERYIYNREEFVRFDSDVGEFRAVTELGRPDEDYWNSQKDLLEEKRAVPDRVCRHNYELDEAVTLQRR/DKYRTFVATFGAASNKAFAE	proteinmpnn_test_binder_nonbinder/out/alignment/184p_with_pep.tsv	184p/184p
HVSTYAAFVQTHRPTGEFMFEFDEDEQFYVDLDKKETVWHLEEFGRAFSFEAQGGLANIAILNNNLNTLIQRSNHTQ/VYQGRQECYAFNGTQRFLERYIYNREEYARFDSDVGEFRAVTELGRPAAEYWNSQKDILEEKRAVPDRVCRHNYELDEAVTLQRR/APEVKKTVFETALKK	proteinmpnn_test_binder_nonbinder/out/alignment/185p_with_pep.tsv	185p/185p
HVSTYAMFVQTHRPTGEFMFEFDEDEMFYVDLDKKETVWHLEEFGQAFSFEAQGGLANIAISNNNLNTLIQRSNHTQ/LFQGRQECYAFNGTQRFLERYIYNREEFVRFDSDVGEFRAVTELGRPDEEYWNSQKDILEEKRAVPDRMCRHNYELGGPMTLQRR/GIVVAWKVRLLPVPP	proteinmpnn_test_binder_nonbinder/out/alignment/187p_with_pep.tsv	187p/187p
HVSTYAAFVQTHRPTGEFMFEFDEDEMFYVDLDKKETVWHLEEFGQAFSFEAQGGLANIAILNNNLNTLIQRSNHTQ/LFQGRQECYAFNGTQRFLERYIYNREEFARFDSDVGEFRAVTELGRPAAEYWNSQKDILEEKRAVPDRMCRHNYELGGPMTLQRR/SLFFSAQPFEITAST	proteinmpnn_test_binder_nonbinder/out/alignment/186p_with_pep.tsv	186p/186p
DHVASCGVNLYQFYGPSGQYTHEFDGDEEFYVDLERKETAWRWPEFSKFGGFDPQGALRNMAVAKHNLNIMIKRYNSTA/FVYQFKGLCYFTNGTERVRGVTRHIYNREEYVRFDSDVGVYRAVTPQGRPVAEYWNSQKEVLEGARASVDRVCRHNYEVAYRGILQRR/SQDLELSWNLNGLQAC	proteinmpnn_test_binder_nonbinder/out/alignment/188p_with_pep.tsv	188p/188p
HVSTYAAFVQTHRPTGEFMFEFDEDEQFYVDLDKKETVWHLEEFGRAFSFEAQGGLANIAILNNNLNTLIQRSNHTQ/VYQGRQECYAFNGTQRFLERYIYNREEYARFDSDVGEFRAVTELGRPAAEYWNSQKDILEEKRAVPDRVCRHNYELDEAVTLQRR/EGKYFAATQFEPLAA	proteinmpnn_test_binder_nonbinder/out/alignment/189p_with_pep.tsv	189p/189p
HVSTYAAFVQTHRPTGEFMFEFDEDEQFYVDLDKKETVWHLEEFGRAFSFEAQGGLANIAILNNNLNTLIQRSNHTQ/LFQGRQECYAFNGTQRFLERYIYNREELVRFDSDVGEFRAVTELGRPEAEYWNSQKDILEEKRAVPDRMCRHNYELDEAVTLQRR/AYESYKFIPALEAAVKQAYAATVAAA	proteinmpnn_test_binder_nonbinder/out/alignment/191p_with_pep.tsv	191p/191p
DHVASCGVNLYQFYGPSGQYTHEFDGDEEFYVDLERKETAWRWPEFSKFGGFDPQGALRNMAVAKHNLNIMIKRYNSTA/FVYQFKGLCYFTNGTERVRGVTRHIYNREEYVRFDSDVGVYRAVTPQGRPVAEYWNSQKEVLEGARASVDRVCRHNYEVAYRGILQRR/SQDLELSWNLNGLAAY	proteinmpnn_test_binder_nonbinder/out/alignment/190p_with_pep.tsv	190p/190p
HVSTYAMFVQTHRPTGEFMFEFDEDEMFYVDLDKKETVWHLEEFGQAFSFEAQGGLANIAISNNNLNTLIQRSNHTQ/LFQGRQECYAFNGTQRFLERYIYNREEFVRFDSDVGEFRAVTELGRPDEEYWNSQKDILEEKRAVPDRMCRHNYELGGPMTLQRR/EKKYFAATQFEPLKA	proteinmpnn_test_binder_nonbinder/out/alignment/192p_with_pep.tsv	192p/192p
DHVASCGVNLYQFYGPSGQYTHEFDGDEQFYVDLERKETAWRWPEFSKFGGFDPQGALRNMAVAKHNLNIMIKRYNSTA/FVFQFKGMCYFTNGTERVRLVTRYIYNREEYARFDSDVGVYRAVTPQGRPDAEYWNSQKEVLEGTRAELDTVCRHNYEVAFRGILQRR/TSKLDAAYKLAYKTAEGATP	proteinmpnn_test_binder_nonbinder/out/alignment/193p_with_pep.tsv	193p/193p
HVSTYAAFVQTHRPTGEFMFEFDEDEMFYVDLDKKETVWHLEEFGQAFSFEAQGGLANIAILNNNLNTLIQRSNHTQ/VYQLRQECYAFNGTQRFLERYIYNREEFVRFDSDVGEFRAVTELGRPDEDYWNSQKDLLEEERAVPDRMCRHNYELDEAVTLQRR/EKKYFAATQFGPLAA	proteinmpnn_test_binder_nonbinder/out/alignment/195p_with_pep.tsv	195p/195p
HVSTYAAFVQTHRPTGEFMFEFDEDEQFYVDLDKKETVWHLEEFGRAFSFEAQGGLANIAILNNNLNTLIQRSNHTQ/LFQGRQECYAFNGTQRFLERYIYNREELVRFDSDVGEFRAVTELGRPEAEYWNSQKDILEEKRAVPDRMCRHNYELDEAVTLQRR/QGIRYANPIAFFRKE	proteinmpnn_test_binder_nonbinder/out/alignment/194p_with_pep.tsv	194p/194p
HVSTYAAFVQTHRPTGEFMFEFDEDEMFYVDLDKKETVWHLEEFGQAFSFEAQGGLANIAILNNNLNTLIQRSNHTQ/LFQGRQECYAFNGTQRFLERYIYNREEFARFDSDVGEFRAVTELGRPAAEYWNSQKDILEEKRAVPDRMCRHNYELGGPMTLQRR/AVPWYAVAFNAIVAA	proteinmpnn_test_binder_nonbinder/out/alignment/196p_with_pep.tsv	196p/196p
HVSTYAAFVQTHRPTGEFMFEFDEDEMFYVDLDKKETVWHLEEFGQAFSFEAQGGLANIAILNNNLNTLIQRSNHTQ/LFQGRQECYAFNGTQRFLERYIYNREEFARFDSDVGEFRAVTELGRPAAEYWNSQKDILEEKRAVPDRMCRHNYELGGPMTLQRR/NKKYFAATQFEPLAA	proteinmpnn_test_binder_nonbinder/out/alignment/197p_with_pep.tsv	197p/197p
HVSTYAAFVQTHRPTGEFMFEFDEDEMFYVDLDKKETVWHLEEFGQAFSFEAQGGLANIAILNNNLNTLIQRSNHTQ/VYQLRQECYAFNGTQRFLERYIYNREEFVRFDSDVGEFRAVTELGRPDEDYWNSQKDLLEEERAVPDRMCRHNYELDEAVTLQRR/EKKYFAANQFEPLAA	proteinmpnn_test_binder_nonbinder/out/alignment/199p_with_pep.tsv	199p/199p
DHVASYGVNLYQSYGPSGQYTHEFDGDEQFYVDLGRKETVWCLPVLRQFRFDPQFALTNIAVLKHNLNSLIKRSNSTA/FVYQFKAMCYFTNGTERVRYVTRYIYNREEYARFDSDVEVYRAVTPLGPPDAEYWNSQKEVLERTRAELDTVCRHNYQLELRTTLQRR/FLAVAVVLGLATSPT	proteinmpnn_test_binder_nonbinder/out/alignment/198p_with_pep.tsv	198p/198p
HVSTYAAFVQTHRPTGEFMFEFDEDEMFYVDLDKKETVWHLEEFGQAFSFEAQGGLANIAILNNNLNTLIQRSNHTQ/VYQLRQECYAFNGTQRFLERYIYNREEFVRFDSDVGEFRAVTELGRPDEDYWNSQKDLLEEERAVPDRMCRHNYELDEAVTLQRR/EKKYFLATQFEPLAA	proteinmpnn_test_binder_nonbinder/out/alignment/200p_with_pep.tsv	200p/200p
HVSTYAAFVQTHRPTGEFMFEFDEDEQFYVDLDKKETVWHLEEFGRAFSFEAQGGLANIAILNNNLNTLIQRSNHTQ/LFQGRQECYAFNGTQRFLERYIYNREELVRFDSDVGEFRAVTELGRPEAEYWNSQKDILEEKRAVPDRMCRHNYELDEAVTLQRR/EKKYFAATQFELLAA	proteinmpnn_test_binder_nonbinder/out/alignment/201p_with_pep.tsv	201p/201p
HVSTYAMFVQTHRPTGEFMFEFDEDEMFYVDLDKKETVWHLEEFGQAFSFEAQGGLANIAISNNNLNTLIQRSNHTQ/LFQGRQECYAFNGTQRFLERYIYNREEFVRFDSDVGEFRAVTELGRPDEEYWNSQKDILEEKRAVPDRMCRHNYELGGPMTLQRR/EKKYFAATQFEPLAN	proteinmpnn_test_binder_nonbinder/out/alignment/203p_with_pep.tsv	203p/203p
HVSTYAAFVQTHRPTGEFMFEFDEDEQFYVDLDKKETVWHLEEFGRAFSFEAQGGLANIAILNNNLNTLIQRSNHTQ/VYQGRQECYAFNGTQRFLERYIYNREEYARFDSDVGEFRAVTELGRPAAEYWNSQKDILEEKRAVPDRVCRHNYELDEAVTLQRR/EKKYFAATQFEKLAA	proteinmpnn_test_binder_nonbinder/out/alignment/202p_with_pep.tsv	202p/202p
HVSTYAAFVQTHRPTGEFMFEFDEDEMFYVDLDKKETVWHLEEFGQAFSFEAQGGLANIAILNNNLNTLIQRSNHTQ/VYQLRQECYAFNGTQRFLERYIYNREEFVRFDSDVGEFRAVTELGRPDEDYWNSQKDLLEEERAVPDRMCRHNYELDEAVTLQRR/EKKYFAATKFEPLAA	proteinmpnn_test_binder_nonbinder/out/alignment/204p_with_pep.tsv	204p/204p
DHVASCGVNLYQFYGPSGQYTHEFDGDEQFYVDLERKETAWRWPEFSKFGGFDPQGALRNMAVAKHNLNIMIKRYNSTA/FVYQFKGLCYFTNGTERVRGVTRHIYNREEYVRFDSDVGVYRAVTPQGRPSAEYWNSQKEVLEGARASVDRVCRHNYEVAYRGILQRR/GEVLNALAYDVPIPG	proteinmpnn_test_binder_nonbinder/out/alignment/205p_with_pep.tsv	205p/205p
HVSTYAAFVQTHRPTGEFMFEFDEDEMFYVDLDKKETVWHLEEFGQAFSFEAQGGLANIAILNNNLNTLIQRSNHTQ/VYQLRQECYAFNGTQRFLERYIYNREEFVRFDSDVGEFRAVTELGRPDEDYWNSQKDLLEEERAVPDRMCRHNYELDEAVTLQRR/EKKYFEATQFEPLAA	proteinmpnn_test_binder_nonbinder/out/alignment/207p_with_pep.tsv	207p/207p
HVSTYAMFVQTHRPTGEFMFEFDEDEMFYVDLDKKETVWHLEEFGQAFSFEAQGGLANIAISNNNLNTLIQRSNHTQ/LFQGRQECYAFNGTQRFLERYIYNREEFVRFDSDVGEFRAVTELGRPDEEYWNSQKDILEEKRAVPDRMCRHNYELGGPMTLQRR/EKKYFKATQFEPLAA	proteinmpnn_test_binder_nonbinder/out/alignment/206p_with_pep.tsv	206p/206p
DHVASCGVNLYQFYGPSGQYTHEFDGDEQFYVDLERKETAWRWPEFSKFGGFDPQGALRNMAVAKHNLNIMIKRYNSTA/FVFQFKGMCYFTNGTERVRLVTRYIYNREEYARFDSDVGVYRAVTPQGRPDAEYWNSQKEVLEGTRAELDTVCRHNYEVAFRGILQRR/INEYTAAAIAYGLDR	proteinmpnn_test_binder_nonbinder/out/alignment/209p_with_pep.tsv	209p/209p
HVSTYAAFVQTHRPTGEFMFEFDEDEMFYVDLDKKETVWHLEEFGQAFSFEAQGGLANIAILNNNLNTLIQRSNHTQ/LFQGRQECYAFNGTQRFLERYIYNREEFVRFDSDVGEFRAVTELGRPDEEYWNSQKDILEEERAVPDRMCRHNYELGGPMTLQRR/RKGVLFNIQYVNYWF	proteinmpnn_test_binder_nonbinder/out/alignment/208p_with_pep.tsv	208p/208p
HVSTYAAFVQTHRPTGEFMFEFDEDEQFYVDLDKKETVWHLEEFGRAFSFEAQGGLANIAILNNNLNTLIQRSNHTQ/LFQGRQECYAFNGTQRFLERYIYNREELVRFDSDVGEFRAVTELGRPEAEYWNSQKDILEEKRAVPDRMCRHNYELDEAVTLQRR/EKKYFAATQFEPLAD	proteinmpnn_test_binder_nonbinder/out/alignment/210p_with_pep.tsv	210p/210p
HVSTYAAFVQTHRPTGEFMFEFDEDEMFYVDLDKKETVWHLEEFGQAFSFEAQGGLANIAILNNNLNTLIQRSNHTQ/VYQLRQECYAFNGTQRFLERYIYNREEFVRFDSDVGEFRAVTELGRPDEDYWNSQKDLLEEERAVPDRMCRHNYELDEAVTLQRR/EKTYFAATQFEPLAA	proteinmpnn_test_binder_nonbinder/out/alignment/211p_with_pep.tsv	211p/211p
HVSTYAAFVQTHRPTGEFMFEFDEDEMFYVDLDKKETVWHLEEFGQAFSFEAQGGLANIAILNNNLNTLIQRSNHTQ/VYQLRQECYAFNGTQRFLERYIYNREEFVRFDSDVGEFRAVTELGRPDEDYWNSQKDLLEEERAVPDRMCRHNYELDEAVTLQRR/EKKYLAATQFEPLAA	proteinmpnn_test_binder_nonbinder/out/alignment/213p_with_pep.tsv	213p/213p
DHVASYGVNLYQSYGPSGQYTHEFDGDEQFYVDLGRKETVWCLPVLRQFRFDPQFALTNIAVLKHNLNSLIKRSNSTA/FVFQFKGMCYFTNGTERVRGVTRYIYNREEYARFDSDVGVYRAVTPLGRLDAEYWNSQKDILEEDRASVDTVCRHNYQLELRTTLQRR/DGCWYPMEIRPRKTH	proteinmpnn_test_binder_nonbinder/out/alignment/212p_with_pep.tsv	212p/212p
HVSTYAAFVQTHRPTGEFMFEFDEDEQFYVDLDKKETVWHLEEFGRAFSFEAQGGLANIAILNNNLNTLIQRSNHTQ/VHQLRQECYAFNGTQRFLERYIYNREEFVRFDSDVGEFRAVTELGRPDEDYWNSQKDLLEEKRAVPDRVCRHNYELDEAVTLQRR/KRHRLIGAVVLAVSV	proteinmpnn_test_binder_nonbinder/out/alignment/214p_with_pep.tsv	214p/214p
HVSTYAAFVQTHRPTGEFMFEFDEDEMFYVDLDKKETVWHLEEFGQAFSFEAQGGLANIAILNNNLNTLIQRSNHTQ/VYQLRQECYAFNGTQRFLERYIYNREEFVRFDSDVGEFRAVTELGRPDEDYWNSQKDLLEEKRAVPDRVCRHNYELDEAVTLQRR/VTANRAELKALIASN	proteinmpnn_test_binder_nonbinder/out/alignment/215p_with_pep.tsv	215p/215p
HVSTYAAFVQTHRPTGEFMFEFDEDEMFYVDLDKKETVWHLEEFGQAFSFEAQGGLANIAILNNNLNTLIQRSNHTQ/VYQLRQECYAFNGTQRFLERYIYNREEFVRFDSDVGEFRAVTELGRPDEDYWNSQKDLLEEERAVPDRMCRHNYELDEAVTLQRR/EKKYVAATQFEPLAA	proteinmpnn_test_binder_nonbinder/out/alignment/217p_with_pep.tsv	217p/217p
DHVASYGVNLYQSYGPSGQYTHEFDGDEQFYVDLGRKETVWCLPVLRQFRFDPQFALTNIAVLKHNLNSLIKRSNSTA/FVYQFKAMCYFTNGTERVRYVTRYIYNREEYARFDSDVEVYRAVTPLGPPDAEYWNSQKEVLERTRAELDTVCRHNYQLELRTTLQRR/VALFAVFLGSAHGIP	proteinmpnn_test_binder_nonbinder/out/alignment/216p_with_pep.tsv	216p/216p
DHVASCGVNLYQFYGPSGQYTHEFDGDEQFYVDLERKETAWRWPEFSKFGGFDPQGALRNMAVAKHNLNIMIKRYNSTA/FVFQFKGMCYFTNGTERVRLVTRYIYNREEYARFDSDVGVYRAVTPQGRPDAEYWNSQKEVLEGTRAELDTVCRHNYEVAFRGILQRR/FKVAATAAATAPADDKFTVF	proteinmpnn_test_binder_nonbinder/out/alignment/218p_with_pep.tsv	218p/218p
HVSTYAAFVQTHRPTGEFMFEFDEDEQFYVDLDKKETVWHLEEFGRAFSFEAQGGLANIAILNNNLNTLIQRSNHTQ/VYQGRQECYAFNGTQRFLERYIYNREEYARFDSDVGEFRAVTELGRPAAEYWNSQKDILEEKRAVPDRVCRHNYELDEAVTLQRR/NNKYAASSYLSLTPE	proteinmpnn_test_binder_nonbinder/out/alignment/219p_with_pep.tsv	219p/219p
HVSTYAMFVQTHRPTGEFMFEFDEDEMFYVDLDKKETVWHLEEFGQAFSFEAQGGLANIAISNNNLNTLIQRSNHTQ/LFQGRQECYAFNGTQRFLERYIYNREEFVRFDSDVGEFRAVTELGRPDEEYWNSQKDILEEKRAVPDRMCRHNYELGGPMTLQRR/EKKYFTATQFEPLAA	proteinmpnn_test_binder_nonbinder/out/alignment/221p_with_pep.tsv	221p/221p
HVSTYAMFVQTHRPTGEFMFEFDEDEMFYVDLDKKETVWHLEEFGQAFSFEAQGGLANIAISNNNLNTLIQRSNHTQ/LFQGRQECYAFNGTQRFLERYIYNREEFVRFDSDVGEFRAVTELGRPDEEYWNSQKDILEEKRAVPDRMCRHNYELGGPMTLQRR/EKKYFVATQFEPLAA	proteinmpnn_test_binder_nonbinder/out/alignment/220p_with_pep.tsv	220p/220p
HVSTYAAFVQTHRPTGEFMFEFDEDEQFYVDLDKKETVWHLEEFGRAFSFEAQGGLANIAILNNNLNTLIQRSNHTQ/VHQLRQECYAFNGTQRFLERYIYNREEFVRFDSDVGEFRAVTELGRPDEDYWNSQKDLLEEKRAVPDRVCRHNYELDEAVTLQRR/AFKVATTAANAAPAN	proteinmpnn_test_binder_nonbinder/out/alignment/222p_with_pep.tsv	222p/222p
HVSTYAAFVQTHRPTGEFMFEFDEDEMFYVDLDKKETVWHLEEFGQAFSFEAQGGLANIAILNNNLNTLIQRSNHTQ/VYQLRQECYAFNGTQRFLERYIYNREEFVRFDSDVGEFRAVTELGRPDEDYWNSQKDLLEEERAVPDRMCRHNYELDEAVTLQRR/EKKYFAATHFEPLAA	proteinmpnn_test_binder_nonbinder/out/alignment/223p_with_pep.tsv	223p/223p
DHVASYGVNLYQSYGPSGQFTHEFDGDEEFYVDLERKETVWKLPLFHRLRFDPQFALTNIAVLKHNLNILIKRSNSTA/FVYQFKAMCYFTNGTERVRYVTRYIYNREEYARFDSDVEVYRAVTPLGPPDAEYWNSQKEVLERTRAELDTVCRHNYQLELRTTLQRR/TPFSLAEGIVLASAA	proteinmpnn_test_binder_nonbinder/out/alignment/225p_with_pep.tsv	225p/225p
HVSTYAAFVQTHRPTGEFMFEFDEDEQFYVDLDKKETVWHLEEFGRAFSFEAQGGLANIAILNNNLNTLIQRSNHTQ/VYQGRQECYAFNGTQRFLERYIYNREEYARFDSDVGEFRAVTELGRPAAEYWNSQKDILEEKRAVPDRVCRHNYELDEAVTLQRR/QKKYFAATQFEPLAA	proteinmpnn_test_binder_nonbinder/out/alignment/224p_with_pep.tsv	224p/224p
DHVASCGVNLYQFYGPSGQYTHEFDGDEQFYVDLERKETAWRWPEFSKFGGFDPQGALRNMAVAKHNLNIMIKRYNSTA/FVFQFKGMCYFTNGTERVRLVTRYIYNREEYARFDSDVGVYRAVTPQGRPDAEYWNSQKEVLEGTRAELDTVCRHNYEVAFRGILQRR/INEPFAAAIAYGLDR	proteinmpnn_test_binder_nonbinder/out/alignment/226p_with_pep.tsv	226p/226p
DHVASYGVNLYQSYGPSGQYTHEFDGDEQFYVDLGRKETVWCLPVLRQFRFDPQFALTNIAVLKHNLNSLIKRSNSTA/FVYQFKAMCYFTNGTERVRYVTRYIYNREEYARFDSDVEVYRAVTPLGPPDAEYWNSQKEVLERTRAELDTVCRHNYQLELRTTLQRR/DPWTIYAIGGSSNPT	proteinmpnn_test_binder_nonbinder/out/alignment/227p_with_pep.tsv	227p/227p
HVSTYAAFVQTHRPTGEFMFEFDEDEMFYVDLDKKETVWHLEEFGQAFSFEAQGGLANIAILNNNLNTLIQRSNHTQ/VYQLRQECYAFNGTQRFLERYIYNREEFVRFDSDVGEFRAVTELGRPDEDYWNSQKDLLEEERAVPDRMCRHNYELDEAVTLQRR/EKKYFSATQFEPLAA	proteinmpnn_test_binder_nonbinder/out/alignment/229p_with_pep.tsv	229p/229p
DHVASYGVNLYQSYGPSGQYTHEFDGDEQFYVDLGRKETVWCLPVLRQFRFDPQFALTNIAVLKHNLNSLIKRSNSTA/FVYQFKAMCYFTNGTERVRYVTRYIYNREEYARFDSDVEVYRAVTPLGPPDAEYWNSQKEVLERTRAELDTVCRHNYQLELRTTLQRR/FKVAATAANAAPAND	proteinmpnn_test_binder_nonbinder/out/alignment/228p_with_pep.tsv	228p/228p
DHVASCGVNLYQFYGPSGQYTHEFDGDEQFYVDLERKETAWRWPEFSKFGGFDPQGALRNMAVAKHNLNIMIKRYNSTA/FVFQFKGMCYFTNGTERVRLVTRYIYNREEYARFDSDVGVYRAVTPQGRPDAEYWNSQKEVLEGTRAELDTVCRHNYEVAFRGILQRR/SSSSSLLAMAVLAAL	proteinmpnn_test_binder_nonbinder/out/alignment/230p_with_pep.tsv	230p/230p
HVSTYAAFVQTHRPTGEFMFEFDEDEMFYVDLDKKETVWHLEEFGQAFSFEAQGGLANIAILNNNLNTLIQRSNHTQ/LFQGRQECYAFNGTQRFLERYIYNREEFARFDSDVGEFRAVTELGRPAAEYWNSQKDILEEKRAVPDRMCRHNYELGGPMTLQRR/THGIRPVVSTQLLLY	proteinmpnn_test_binder_nonbinder/out/alignment/231p_with_pep.tsv	231p/231p
HVSTYAAFVQTHRPTGEFMFEFDEDEQFYVDLDKKETVWHLEEFGRAFSFEAQGGLANIAILNNNLNTLIQRSNHTQ/VYQGRQECYAFNGTQRFLERYIYNREEYARFDSDVGEFRAVTELGRPAAEYWNSQKDILEEKRAVPDRVCRHNYELDEAVTLQRR/EKKYFAATQFEPNAA	proteinmpnn_test_binder_nonbinder/out/alignment/233p_with_pep.tsv	233p/233p
HVSTYAAFVQTHRPTGEFMFEFDEDEMFYVDLDKKETVWHLEEFGQAFSFEAQGGLANIAILNNNLNTLIQRSNHTQ/VYQLRQECYAFNGTQRFLERYIYNREEFVRFDSDVGEFRAVTELGRPDEDYWNSQKDLLEEKRAVPDRVCRHNYELDEAVTLQRR/AYESYKFIPALEAAV	proteinmpnn_test_binder_nonbinder/out/alignment/232p_with_pep.tsv	232p/232p
HVSTYAAFVQTHRPTGEFMFEFDEDEMFYVDLDKKETVWHLEEFGQAFSFEAQGGLANIAILNNNLNTLIQRSNHTQ/VYQLRQECYAFNGTQRFLERYIYNREEFVRFDSDVGEFRAVTELGRPDEDYWNSQKDLLEEERAVPDRMCRHNYELDEAVTLQRR/EKKRFAATQFEPLAA	proteinmpnn_test_binder_nonbinder/out/alignment/234p_with_pep.tsv	234p/234p
DHVASCGVNLYQFYGPSGQYTHEFDGDEEFYVDLERKETAWRWPEFSKFGGFDPQGALRNMAVAKHNLNIMIKRYNSTA/FVYQFKGLCYFTNGTERVRGVTRHIYNREEYVRFDSDVGVYRAVTPQGRPVAEYWNSQKEVLEGARASVDRVCRHNYEVAYRGILQRR/SQDLELSWNLNGLPAY	proteinmpnn_test_binder_nonbinder/out/alignment/235p_with_pep.tsv	235p/235p
DHVASCGVNLYQFYGPSGQYTHEFDGDEQFYVDLERKETAWRWPEFSKFGGFDPQGALRNMAVAKHNLNIMIKRYNSTA/FVFQFKGMCYFTNGTERVRLVTRYIYNREEYARFDSDVGVYRAVTPQGRPDAEYWNSQKEVLEGTRAELDTVCRHNYEVAFRGILQRR/INEPTAACIAYGLDR	proteinmpnn_test_binder_nonbinder/out/alignment/237p_with_pep.tsv	237p/237p
HVSTYAAFVQTHRPTGEFMFEFDEDEMFYVDLDKKETVWHLEEFGQAFSFEAQGGLANIAILNNNLNTLIQRSNHTQ/LFQGRQECYAFNGTQRFLERYIYNREEFARFDSDVGEFRAVTELGRPAAEYWNSQKDILEEKRAVPDRMCRHNYELGGPMTLQRR/ECKYFAATQFEPLAA	proteinmpnn_test_binder_nonbinder/out/alignment/238p_with_pep.tsv	238p/238p
EADHVGFYGTTVYQSPGDIGQYTHEFDGDELFYVDLDKKKTVWRLPEFGQLILFEPQGGLQNIAAEKHNLGILTKRSNFTPA/HFVVQFKGECYYTNGTQRIRLVTRYIYNREEYVRYDSDVGEYRAVTELGRPDAEYWNSQPEILDRTRAEVDTACRHNYEGPETSTSLRR/TLWQRPVVTIKIGGQLKEAL	proteinmpnn_test_binder_nonbinder/out/alignment/236p_with_pep.tsv	236p/236p
HVSTYAMFVQTHRPTGEFMFEFDEDEMFYVDLDKKETVWHLEEFGQAFSFEAQGGLANIAISNNNLNTLIQRSNHTQ/LFQGRQECYAFNGTQRFLERYIYNREEFVRFDSDVGEFRAVTELGRPDEEYWNSQKDILEEKRAVPDRMCRHNYELGGPMTLQRR/EKKYFAATYFEPLAA	proteinmpnn_test_binder_nonbinder/out/alignment/239p_with_pep.tsv	239p/239p
DHVASYGVNLYQSYGPSGQYTHEFDGDEQFYVDLGRKETVWCLPVLRQFRFDPQFALTNIAVLKHNLNSLIKRSNSTA/FVYQFKGMCYFTNGTERVRLVSRSIYNREEIVRFDSDVGEFRAVTLLGLPAAEYWNSQKDILERKRAAVDRVCRHNYQLELRTTLQRR/ELFVAAYVPYVAWLV	proteinmpnn_test_binder_nonbinder/out/alignment/240p_with_pep.tsv	240p/240p
HVSTYAMFVQTHRPTGEFMFEFDEDEMFYVDLDKKETVWHLEEFGQAFSFEAQGGLANIAISNNNLNTLIQRSNHTQ/LFQGRQECYAFNGTQRFLERYIYNREEFVRFDSDVGEFRAVTELGRPDEEYWNSQKDILEEKRAVPDRMCRHNYELGGPMTLQRR/EKKYFAATQFEDLAA	proteinmpnn_test_binder_nonbinder/out/alignment/242p_with_pep.tsv	242p/242p
HVSTYAAFVQTHRPTGEFMFEFDEDEQFYVDLDKKETVWHLEEFGRAFSFEAQGGLANIAILNNNLNTLIQRSNHTQ/VHQLRQECYAFNGTQRFLERYIYNREEFVRFDSDVGEFRAVTELGRPDEDYWNSQKDLLEEKRAVPDRVCRHNYELDEAVTLQRR/AFKVAATAANAAPYN	proteinmpnn_test_binder_nonbinder/out/alignment/241p_with_pep.tsv	241p/241p
HVSTYAAFVQTHRPTGEFMFEFDEDEQFYVDLDKKETVWHLEEFGRAFSFEAQGGLANIAILNNNLNTLIQRSNHTQ/VYQGRQECYAFNGTQRFLERYIYNREEYARFDSDVGEFRAVTELGRPAAEYWNSQKDILEEKRAVPDRVCRHNYELDEAVTLQRR/VYGIFYATSFLDLYR	proteinmpnn_test_binder_nonbinder/out/alignment/243p_with_pep.tsv	243p/243p
HVSTYAAFVQTHRPTGEFMFEFDEDEMFYVDLDKKETVWHLEEFGQAFSFEAQGGLANIAILNNNLNTLIQRSNHTQ/VYQLRQECYAFNGTQRFLERYIYNREEFVRFDSDVGEFRAVTELGRPDEDYWNSQKDLLEEERAVPDRMCRHNYELDEAVTLQRR/EKKYFAATQFTPLAA	proteinmpnn_test_binder_nonbinder/out/alignment/244p_with_pep.tsv	244p/244p
HVSTYAMFVQTHRPTGEFMFEFDEDEMFYVDLDKKETVWHLEEFGQAFSFEAQGGLANIAISNNNLNTLIQRSNHTQ/LFQGRQECYAFNGTQRFLERYIYNREEFVRFDSDVGEFRAVTELGRPDEEYWNSQKDILEEKRAVPDRMCRHNYELGGPMTLQRR/EKAYFAATQFEPLAA	proteinmpnn_test_binder_nonbinder/out/alignment/246p_with_pep.tsv	246p/246p
DHVASCGVNLYQFYGPSGQYTHEFDGDEEFYVDLERKETAWRWPEFSKFGGFDPQGALRNMAVAKHNLNIMIKRYNSTA/FVYQFKGLCYFTNGTERVRGVTRHIYNREEYVRFDSDVGVYRAVTPQGRPVAEYWNSQKEVLEGARASVDRVCRHNYEVAYRGILQRR/NFRFMSKGGMRNVFDEVIPT	proteinmpnn_test_binder_nonbinder/out/alignment/245p_with_pep.tsv	245p/245p
HVSTYAAFVQTHRPTGEFMFEFDEDEQFYVDLDKKETVWHLEEFGRAFSFEAQGGLANIAILNNNLNTLIQRSNHTQ/LFQGRQECYAFNGTQRFLERYIYNREELVRFDSDVGEFRAVTELGRPEAEYWNSQKDILEEKRAVPDRMCRHNYELDEAVTLQRR/LYKYKVVKIEPLGVAPTKAK	proteinmpnn_test_binder_nonbinder/out/alignment/247p_with_pep.tsv	247p/247p
DHVASYGVNLYQSYGPSGQFTHEFDGDEEFYVDLERKETVWKLPLFHRLRFDPQFALTNIAVLKHNLNILIKRSNSTA/FVFQFKGMCYFTNGTERVRGVTRYIYNREEYARFDSDVGVYRAVTPLGRLDAEYWNSQKDILEEDRASVDTVCRHNYQLELRTTLQRR/RPGLLIGFGLRTLWS	proteinmpnn_test_binder_nonbinder/out/alignment/248p_with_pep.tsv	248p/248p
HVSTYAAFVQTHRPTGEFMFEFDEDEQFYVDLDKKETVWHLEEFGRAFSFEAQGGLANIAILNNNLNTLIQRSNHTQ/LFQGRQECYAFNGTQRFLERYIYNREELVRFDSDVGEFRAVTELGRPEAEYWNSQKDILEEKRAVPDRMCRHNYELDEAVTLQRR/GIRYANPIAFFRKEP	proteinmpnn_test_binder_nonbinder/out/alignment/250p_with_pep.tsv	250p/250p
DHVASCGVNLYQFYGPSGQYTHEFDGDEQFYVDLERKETAWRWPEFSKFGGFDPQGALRNMAVAKHNLNIMIKRYNSTA/FVFQFKGMCYFTNGTERVRLVTRYIYNREEYARFDSDVGVYRAVTPQGRPDAEYWNSQKEVLEGTRAELDTVCRHNYEVAFRGILQRR/HNEPTAAAIAYGLDR	proteinmpnn_test_binder_nonbinder/out/alignment/249p_with_pep.tsv	249p/249p
DHVASCGVNLYQFYGPSGQYTHEFDGDEQFYVDLERKETAWRWPEFSKFGGFDPQGALRNMAVAKHNLNIMIKRYNSTA/FVFQFKGMCYFTNGTERVRLVTRYIYNREEYARFDSDVGVYRAVTPQGRPDAEYWNSQKEVLEGTRAELDTVCRHNYEVAFRGILQRR/AAATAGTTVYYAFAA	proteinmpnn_test_binder_nonbinder/out/alignment/251p_with_pep.tsv	251p/251p
HVSTYAAFVQTHRPTGEFMFEFDEDEQFYVDLDKKETVWHLEEFGRAFSFEAQGGLANIAILNNNLNTLIQRSNHTQ/VYQGRQECYAFNGTQRFLERYIYNREEYARFDSDVGEFRAVTELGRPAAEYWNSQKDILEEKRAVPDRVCRHNYELDEAVTLQRR/EKKYFARTQFEPLAA	proteinmpnn_test_binder_nonbinder/out/alignment/252p_with_pep.tsv	252p/252p
HVSTYAAFVQTHRPTGEFMFEFDEDEQFYVDLDKKETVWHLEEFGRAFSFEAQGGLANIAILNNNLNTLIQRSNHTQ/VYQGRQECYAFNGTQRFLERYIYNREEYARFDSDVGEFRAVTELGRPAAEYWNSQKDILEEKRAVPDRVCRHNYELDEAVTLQRR/EKKYFAKTQFEPLAA	proteinmpnn_test_binder_nonbinder/out/alignment/254p_with_pep.tsv	254p/254p
HVSTYAMFVQTHRPTGEFMFEFDEDEMFYVDLDKKETVWHLEEFGQAFSFEAQGGLANIAISNNNLNTLIQRSNHTQ/LFQGRQECYAFNGTQRFLERYIYNREEFVRFDSDVGEFRAVTELGRPDEEYWNSQKDILEEKRAVPDRMCRHNYELGGPMTLQRR/PLYKLVHVFINTQYA	proteinmpnn_test_binder_nonbinder/out/alignment/253p_with_pep.tsv	253p/253p
HVSTYAAFVQTHRPTGEFMFEFDEDEQFYVDLDKKETVWHLEEFGRAFSFEAQGGLANIAILNNNLNTLIQRSNHTQ/VHQLRQECYAFNGTQRFLERYIYNREEFVRFDSDVGEFRAVTELGRPDEDYWNSQKDLLEEKRAVPDRVCRHNYELDEAVTLQRR/EALRVIAGALEVHAV	proteinmpnn_test_binder_nonbinder/out/alignment/255p_with_pep.tsv	255p/255p
HVSTYAAFVQTHRPTGEFMFEFDEDEMFYVDLDKKETVWHLEEFGQAFSFEAQGGLANIAILNNNLNTLIQRSNHTQ/LFQGRQECYAFNGTQRFLERYIYNREEFARFDSDVGEFRAVTELGRPAAEYWNSQKDILEEKRAVPDRMCRHNYELGGPMTLQRR/EKKYFAAKQFEPLAA	proteinmpnn_test_binder_nonbinder/out/alignment/256p_with_pep.tsv	256p/256p
HVSTYAMFVQTHRPTGEFMFEFDEDEMFYVDLDKKETVWHLEEFGQAFSFEAQGGLANIAISNNNLNTLIQRSNHTQ/LFQGRQECYAFNGTQRFLERYIYNREEFVRFDSDVGEFRAVTELGRPDEEYWNSQKDILEEKRAVPDRMCRHNYELGGPMTLQRR/EKKDFAATQFEPLAA	proteinmpnn_test_binder_nonbinder/out/alignment/258p_with_pep.tsv	258p/258p
HVSTYAAFVQTHRPTGEFMFEFDEDEQFYVDLDKKETVWHLEEFGRAFSFEAQGGLANIAILNNNLNTLIQRSNHTQ/LFQGRQECYAFNGTQRFLERYIYNREELVRFDSDVGEFRAVTELGRPEAEYWNSQKDILEEKRAVPDRMCRHNYELDEAVTLQRR/EKKYFAVTQFEPLAA	proteinmpnn_test_binder_nonbinder/out/alignment/257p_with_pep.tsv	257p/257p
DHVASCGVNLYQFYGPSGQYTHEFDGDEQFYVDLERKETAWRWPEFSKFGGFDPQGALRNMAVAKHNLNIMIKRYNSTA/FVFQFKGMCYFTNGTERVRLVTRYIYNREEYARFDSDVGVYRAVTPQGRPDAEYWNSQKEVLEGTRAELDTVCRHNYEVAFRGILQRR/INPPTAAAIAYGLDR	proteinmpnn_test_binder_nonbinder/out/alignment/259p_with_pep.tsv	259p/259p
DHVASCGVNLYQFYGPSGQYTHEFDGDEQFYVDLERKETAWRWPEFSKFGGFDPQGALRNMAVAKHNLNIMIKRYNSTA/FVFQFKGMCYFTNGTERVRLVTRYIYNREEYARFDSDVGVYRAVTPQGRPDAEYWNSQKEVLEGTRAELDTVCRHNYEVAFRGILQRR/AAAHAGTTVYGAFAA	proteinmpnn_test_binder_nonbinder/out/alignment/260p_with_pep.tsv	260p/260p
DHVASCGVNLYQFYGPSGQYTHEFDGDEQFYVDLERKETAWRWPEFSKFGGFDPQGALRNMAVAKHNLNIMIKRYNSTA/FVYQFKGLCYFTNGTERVRGVTRHIYNREEYVRFDSDVGVYRAVTPQGRPVAEYWNSQKEVLEGARASVDRVCRHNYEVAYRGILQRR/KASNTILPLMALLTP	proteinmpnn_test_binder_nonbinder/out/alignment/262p_with_pep.tsv	262p/262p
HVSTYAAFVQTHRPTGEFMFEFDEDEMFYVDLDKKETVWHLEEFGQAFSFEAQGGLANIAILNNNLNTLIQRSNHTQ/VYQLRQECYAFNGTQRFLERYIYNREEFVRFDSDVGEFRAVTELGRPDEDYWNSQKDLLEEKRAVPDRVCRHNYELDEAVTLQRR/NKAGVRIYVDIVLNH	proteinmpnn_test_binder_nonbinder/out/alignment/261p_with_pep.tsv	261p/261p
HVSTYAAFVQTHRPTGEFMFEFDEDEMFYVDLDKKETVWHLEEFGQAFSFEAQGGLANIAILNNNLNTLIQRSNHTQ/VYQLRQECYAFNGTQRFLERYIYNREEFVRFDSDVGEFRAVTELGRPDEDYWNSQKDLLEEERAVPDRMCRHNYELDEAVTLQRR/EKKYFAATQFEPFAA	proteinmpnn_test_binder_nonbinder/out/alignment/263p_with_pep.tsv	263p/263p
HVSTYAAFVQTHRPTGEFMFEFDEDEQFYVDLDKKETVWHLEEFGRAFSFEAQGGLANIAILNNNLNTLIQRSNHTQ/VHQLRQECYAFNGTQRFLERYIYNREEFVRFDSDVGEFRAVTELGRPDEDYWNSQKDLLEEKRAVPDRVCRHNYELDEAVTLQRR/EKKYFAATQFFPLAA	proteinmpnn_test_binder_nonbinder/out/alignment/264p_with_pep.tsv	264p/264p
HVSTYAAFVQTHRPTGEFMFEFDEDEMFYVDLDKKETVWHLEEFGQAFSFEAQGGLANIAILNNNLNTLIQRSNHTQ/VYQLRQECYAFNGTQRFLERYIYNREEFVRFDSDVGEFRAVTELGRPDEDYWNSQKDLLEEERAVPDRMCRHNYELDEAVTLQRR/EKKYFIATQFEPLAA	proteinmpnn_test_binder_nonbinder/out/alignment/266p_with_pep.tsv	266p/266p
DHVASCGVNLYQFYGPSGQYTHEFDGDEQFYVDLERKETAWRWPEFSKFGGFDPQGALRNMAVAKHNLNIMIKRYNSTA/FVFQFKGMCYFTNGTERVRLVTRYIYNREEYARFDSDVGVYRAVTPQGRPDAEYWNSQKEVLEGTRAELDTVCRHNYEVAFRGILQRR/IAEPTAAAIAYGLDR	proteinmpnn_test_binder_nonbinder/out/alignment/265p_with_pep.tsv	265p/265p
DHVASYGVNLYQSYGPSGQFTHEFDGDEEFYVDLERKETVWKLPLFHRLRFDPQFALTNIAVLKHNLNILIKRSNSTA/FVYQFKAMCYFTNGTERVRYVTRYIYNREEYARFDSDVEVYRAVTPLGPPDAEYWNSQKEVLERTRAELDTVCRHNYQLELRTTLQRR/WFLPSIRAANVMAAS	proteinmpnn_test_binder_nonbinder/out/alignment/267p_with_pep.tsv	267p/267p
HVSTYAMFVQTHRPTGEFMFEFDEDEMFYVDLDKKETVWHLEEFGQAFSFEAQGGLANIAISNNNLNTLIQRSNHTQ/LFQGRQECYAFNGTQRFLERYIYNREEFVRFDSDVGEFRAVTELGRPDEEYWNSQKDILEEKRAVPDRMCRHNYELGGPMTLQRR/ASPMLYQLLEAVYGN	proteinmpnn_test_binder_nonbinder/out/alignment/268p_with_pep.tsv	268p/268p
HVSTYAAFVQTHRPTGEFMFEFDEDEQFYVDLDKKETVWHLEEFGRAFSFEAQGGLANIAILNNNLNTLIQRSNHTQ/VYQGRQECYAFNGTQRFLERYIYNREEYARFDSDVGEFRAVTELGRPAAEYWNSQKDILEEKRAVPDRVCRHNYELDEAVTLQRR/EKKYFAATMFEPLAA	proteinmpnn_test_binder_nonbinder/out/alignment/270p_with_pep.tsv	270p/270p
HVSTYAAFVQTHRPTGEFMFEFDEDEQFYVDLDKKETVWHLEEFGRAFSFEAQGGLANIAILNNNLNTLIQRSNHTQ/VYQGRQECYAFNGTQRFLERYIYNREEYARFDSDVGEFRAVTELGRPAAEYWNSQKDILEEKRAVPDRVCRHNYELDEAVTLQRR/EKKYFTATQFEPLAA	proteinmpnn_test_binder_nonbinder/out/alignment/269p_with_pep.tsv	269p/269p
HVSTYAAFVQTHRPTGEFMFEFDEDEQFYVDLDKKETVWHLEEFGRAFSFEAQGGLANIAILNNNLNTLIQRSNHTQ/LFQGRQECYAFNGTQRFLERYIYNREELVRFDSDVGEFRAVTELGRPEAEYWNSQKDILEEKRAVPDRMCRHNYELDEAVTLQRR/EKKYFAATQFEVLAA	proteinmpnn_test_binder_nonbinder/out/alignment/271p_with_pep.tsv	271p/271p
HVSTYAAFVQTHRPTGEFMFEFDEDEQFYVDLDKKETVWHLEEFGRAFSFEAQGGLANIAILNNNLNTLIQRSNHTQ/VHQLRQECYAFNGTQRFLERYIYNREEFVRFDSDVGEFRAVTELGRPDEDYWNSQKDLLEEKRAVPDRVCRHNYELDEAVTLQRR/AFKVAATAANAFPAN	proteinmpnn_test_binder_nonbinder/out/alignment/274p_with_pep.tsv	274p/274p
HVSTYAAFVQTHRPTGEFMFEFDEDEQFYVDLDKKETVWHLEEFGRAFSFEAQGGLANIAILNNNLNTLIQRSNHTQ/VHQLRQECYAFNGTQRFLERYIYNREEFVRFDSDVGEFRAVTELGRPDEDYWNSQKDLLEEKRAVPDRVCRHNYELDEAVTLQRR/EKKYFVATQFEPLAA	proteinmpnn_test_binder_nonbinder/out/alignment/272p_with_pep.tsv	272p/272p
HVSTYAAFVQTHRPTGEFMFEFDEDEMFYVDLDKKETVWHLEEFGQAFSFEAQGGLANIAILNNNLNTLIQRSNHTQ/VYQLRQECYAFNGTQRFLERYIYNREEFVRFDSDVGEFRAVTELGRPDEDYWNSQKDLLEEERAVPDRMCRHNYELDEAVTLQRR/GKKYFAATQFEPLAA	proteinmpnn_test_binder_nonbinder/out/alignment/273p_with_pep.tsv	273p/273p
HVSTYAAFVQTHRPTGEFMFEFDEDEMFYVDLDKKETVWHLEEFGQAFSFEAQGGLANIAILNNNLNTLIQRSNHTQ/VYQLRQECYAFNGTQRFLERYIYNREEFVRFDSDVGEFRAVTELGRPDEDYWNSQKDLLEEERAVPDRMCRHNYELDEAVTLQRR/EKKYFAADQFEPLAA	proteinmpnn_test_binder_nonbinder/out/alignment/275p_with_pep.tsv	275p/275p
DHVASYGVNLYQSYGPSGQYTHEFDGDEQFYVDLGRKETVWCLPVLRQFRFDPQFALTNIAVLKHNLNSLIKRSNSTA/FVYQFKAMCYFTNGTERVRYVTRYIYNREEYARFDSDVEVYRAVTPLGPPDAEYWNSQKEVLERTRAELDTVCRHNYQLELRTTLQRR/ISTNIRQAGVQYSR	proteinmpnn_test_binder_nonbinder/out/alignment/277p_with_pep.tsv	277p/277p
HVSTYAMFVQTHRPTGEFMFEFDEDEMFYVDLDKKETVWHLEEFGQAFSFEAQGGLANIAISNNNLNTLIQRSNHTQ/LFQGRQECYAFNGTQRFLERYIYNREEFVRFDSDVGEFRAVTELGRPDEEYWNSQKDILEEKRAVPDRMCRHNYELGGPMTLQRR/FLHYIFMENAFELPT	proteinmpnn_test_binder_nonbinder/out/alignment/278p_with_pep.tsv	278p/278p
EADHVGFYGTTVYQSPGDIGQYTHEFDGDELFYVDLDKKKTVWRLPEFGQLILFEPQGGLQNIAAEKHNLGILTKRSNFTPA/HFVVQFKGECYYTNGTQRIRLVTRYIYNREEYVRYDSDVGEYRAVTELGRPDAEYWNSQPEILDRTRAEVDTACRHNYEGPETSTSLRR/LYKYKVVKIEPLGVAPTKAK	proteinmpnn_test_binder_nonbinder/out/alignment/276p_with_pep.tsv	276p/276p
HVSTYAMFVQTHRPTGEFMFEFDEDEMFYVDLDKKETVWHLEEFGQAFSFEAQGGLANIAISNNNLNTLIQRSNHTQ/LFQGRQECYAFNGTQRFLERYIYNREEFVRFDSDVGEFRAVTELGRPDEEYWNSQKDILEEKRAVPDRMCRHNYELGGPMTLQRR/GVLVATNFFGINTIP	proteinmpnn_test_binder_nonbinder/out/alignment/279p_with_pep.tsv	279p/279p
HVSTYAAFVQTHRPTGEFMFEFDEDEMFYVDLDKKETVWHLEEFGQAFSFEAQGGLANIAILNNNLNTLIQRSNHTQ/VYQLRQECYAFNGTQRFLERYIYNREEFVRFDSDVGEFRAVTELGRPDEDYWNSQKDLLEEERAVPDRMCRHNYELDEAVTLQRR/EKKFFAATQFEPLAA	proteinmpnn_test_binder_nonbinder/out/alignment/282p_with_pep.tsv	282p/282p
HVSTYAAFVQTHRPTGEFMFEFDEDEMFYVDLDKKETVWHLEEFGQAFSFEAQGGLANIAILNNNLNTLIQRSNHTQ/VYQLRQECYAFNGTQRFLERYIYNREEFVRFDSDVGEFRAVTELGRPDEDYWNSQKDLLEEKRAVPDRVCRHNYELDEAVTLQRR/AFKVAPTAANAAPAN	proteinmpnn_test_binder_nonbinder/out/alignment/280p_with_pep.tsv	280p/280p
DHVASYGVNLYQSYGPSGQFTHEFDGDEEFYVDLERKETVWKLPLFHRLRFDPQFALTNIAVLKHNLNILIKRSNSTA/FVFQFKGMCYFTNGTERVRGVTRYIYNREEYARFDSDVGVYRAVTPLGRLDAEYWNSQKDILEEDRASVDTVCRHNYQLELRTTLQRR/ALIAAFSIRPGLLIG	proteinmpnn_test_binder_nonbinder/out/alignment/281p_with_pep.tsv	281p/281p
HVSTYAAFVQTHRPTGEFMFEFDEDEQFYVDLDKKETVWHLEEFGRAFSFEAQGGLANIAILNNNLNTLIQRSNHTQ/VHQLRQECYAFNGTQRFLERYIYNREEFVRFDSDVGEFRAVTELGRPDEDYWNSQKDLLEEKRAVPDRVCRHNYELDEAVTLQRR/EKKYFAAAQFEPLAA	proteinmpnn_test_binder_nonbinder/out/alignment/283p_with_pep.tsv	283p/283p
HVSTYAMFVQTHRPTGEFMFEFDEDEMFYVDLDKKETVWHLEEFGQAFSFEAQGGLANIAISNNNLNTLIQRSNHTQ/LFQGRQECYAFNGTQRFLERYIYNREEFVRFDSDVGEFRAVTELGRPDEEYWNSQKDILEEKRAVPDRMCRHNYELGGPMTLQRR/KRHRLIGAVVLAVSV	proteinmpnn_test_binder_nonbinder/out/alignment/285p_with_pep.tsv	285p/285p
HVSTYAMFVQTHRPTGEFMFEFDEDEMFYVDLDKKETVWHLEEFGQAFSFEAQGGLANIAISNNNLNTLIQRSNHTQ/LFQGRQECYAFNGTQRFLERYIYNREEFVRFDSDVGEFRAVTELGRPDEEYWNSQKDILEEKRAVPDRMCRHNYELGGPMTLQRR/EKKYFAKTQFEPLAA	proteinmpnn_test_binder_nonbinder/out/alignment/286p_with_pep.tsv	286p/286p
HVSTYAAFVQTHRPTGEFMFEFDEDEQFYVDLDKKETVWHLEEFGRAFSFEAQGGLANIAILNNNLNTLIQRSNHTQ/LFQGRQECYAFNGTQRFLERYIYNREELVRFDSDVGEFRAVTELGRPEAEYWNSQKDILEEKRAVPDRMCRHNYELDEAVTLQRR/ANPIAFFRKEPLKEC	proteinmpnn_test_binder_nonbinder/out/alignment/284p_with_pep.tsv	284p/284p
HVSTYAAFVQTHRPTGEFMFEFDEDEMFYVDLDKKETVWHLEEFGQAFSFEAQGGLANIAILNNNLNTLIQRSNHTQ/LFQGRQECYAFNGTQRFLERYIYNREEFARFDSDVGEFRAVTELGRPAAEYWNSQKDILEEKRAVPDRMCRHNYELGGPMTLQRR/EKKYFAATQFEPLAY	proteinmpnn_test_binder_nonbinder/out/alignment/287p_with_pep.tsv	287p/287p
HVSTYAMFVQTHRPTGEFMFEFDEDEMFYVDLDKKETVWHLEEFGQAFSFEAQGGLANIAISNNNLNTLIQRSNHTQ/LFQGRQECYAFNGTQRFLERYIYNREEFVRFDSDVGEFRAVTELGRPDEEYWNSQKDILEEKRAVPDRMCRHNYELGGPMTLQRR/EKKYFAATMFEPLAA	proteinmpnn_test_binder_nonbinder/out/alignment/290p_with_pep.tsv	290p/290p
HVSTYAAFVQTHRPTGEFMFEFDEDEQFYVDLDKKETVWHLEEFGRAFSFEAQGGLANIAILNNNLNTLIQRSNHTQ/VYQGRQECYAFNGTQRFLERYIYNREEYARFDSDVGEFRAVTELGRPAAEYWNSQKDILEEKRAVPDRVCRHNYELDEAVTLQRR/SGFLGPLLVLQAGFFLLTR	proteinmpnn_test_binder_nonbinder/out/alignment/288p_with_pep.tsv	288p/288p
HVSTYAAFVQTHRPTGEFMFEFDEDEQFYVDLDKKETVWHLEEFGRAFSFEAQGGLANIAILNNNLNTLIQRSNHTQ/VYQGRQECYAFNGTQRFLERYIYNREEYARFDSDVGEFRAVTELGRPAAEYWNSQKDILEEKRAVPDRVCRHNYELDEAVTLQRR/EKKYFAATQFEPLAI	proteinmpnn_test_binder_nonbinder/out/alignment/289p_with_pep.tsv	289p/289p
HVSTYAAFVQTHRPTGEFMFEFDEDEMFYVDLDKKETVWHLEEFGQAFSFEAQGGLANIAILNNNLNTLIQRSNHTQ/LFQGRQECYAFNGTQRFLERYIYNREEFARFDSDVGEFRAVTELGRPAAEYWNSQKDILEEKRAVPDRMCRHNYELGGPMTLQRR/EKKYFAATEFEPLAA	proteinmpnn_test_binder_nonbinder/out/alignment/291p_with_pep.tsv	291p/291p
HVSTYAMFVQTHRPTGEFMFEFDEDEMFYVDLDKKETVWHLEEFGQAFSFEAQGGLANIAISNNNLNTLIQRSNHTQ/LFQGRQECYAFNGTQRFLERYIYNREEFVRFDSDVGEFRAVTELGRPDEEYWNSQKDILEEKRAVPDRMCRHNYELGGPMTLQRR/EKKQFAATQFEPLAA	proteinmpnn_test_binder_nonbinder/out/alignment/293p_with_pep.tsv	293p/293p
HVSTYAAFVQTHRPTGEFMFEFDEDEQFYVDLDKKETVWHLEEFGRAFSFEAQGGLANIAILNNNLNTLIQRSNHTQ/VYQGRQECYAFNGTQRFLERYIYNREEYARFDSDVGEFRAVTELGRPAAEYWNSQKDILEEKRAVPDRVCRHNYELDEAVTLQRR/EKKYFAATQFEPLKA	proteinmpnn_test_binder_nonbinder/out/alignment/294p_with_pep.tsv	294p/294p
HVSTYAAFVQTHRPTGEFMFEFDEDEMFYVDLDKKETVWHLEEFGQAFSFEAQGGLANIAILNNNLNTLIQRSNHTQ/LFQGRQECYAFNGTQRFLERYIYNREEFARFDSDVGEFRAVTELGRPAAEYWNSQKDILEEKRAVPDRMCRHNYELGGPMTLQRR/EKKYFIATQFEPLAA	proteinmpnn_test_binder_nonbinder/out/alignment/295p_with_pep.tsv	295p/295p
HVSTYAMFVQTHRPTGEFMFEFDEDEMFYVDLDKKETVWHLEEFGQAFSFEAQGGLANIAISNNNLNTLIQRSNHTQ/LFQGRQECYAFNGTQRFLERYIYNREEFVRFDSDVGEFRAVTELGRPDEEYWNSQKDILEEKRAVPDRMCRHNYELGGPMTLQRR/EKKYFAHTQFEPLAA	proteinmpnn_test_binder_nonbinder/out/alignment/296p_with_pep.tsv	296p/296p
DHVASYGVNLYQSYGPSGQYTHEFDGDEQFYVDLGRKETVWCLPVLRQFRFDPQFALTNIAVLKHNLNSLIKRSNSTA/FVYQFKAMCYFTNGTERVRYVTRYIYNREEYARFDSDVEVYRAVTPLGPPDAEYWNSQKEVLERTRAELDTVCRHNYQLELRTTLQRR/AYESYKFIPALEAAVKQAYAATVAAA	proteinmpnn_test_binder_nonbinder/out/alignment/297p_with_pep.tsv	297p/297p
HVSTYAMFVQTHRPTGEFMFEFDEDEMFYVDLDKKETVWHLEEFGQAFSFEAQGGLANIAISNNNLNTLIQRSNHTQ/LFQGRQECYAFNGTQRFLERYIYNREEFVRFDSDVGEFRAVTELGRPDEEYWNSQKDILEEKRAVPDRMCRHNYELGGPMTLQRR/GKAGCQTYKWETFLT	proteinmpnn_test_binder_nonbinder/out/alignment/298p_with_pep.tsv	298p/298p
DHVASCGVNLYQFYGPSGQYTHEFDGDEQFYVDLERKETAWRWPEFSKFGGFDPQGALRNMAVAKHNLNIMIKRYNSTA/FVFQFKGMCYFTNGTERVRLVTRYIYNREEYARFDSDVGVYRAVTPQGRPDAEYWNSQKEVLEGTRAELDTVCRHNYEVAFRGILQRR/YITQCFLPVFLAQPP	proteinmpnn_test_binder_nonbinder/out/alignment/300p_with_pep.tsv	300p/300p
HVSTYAAFVQTHRPTGEFMFEFDEDEQFYVDLDKKETVWHLEEFGRAFSFEAQGGLANIAILNNNLNTLIQRSNHTQ/LFQGRQECYAFNGTQRFLERYIYNREELVRFDSDVGEFRAVTELGRPEAEYWNSQKDILEEKRAVPDRMCRHNYELDEAVTLQRR/EKKYFAATQFEHLAA	proteinmpnn_test_binder_nonbinder/out/alignment/299p_with_pep.tsv	299p/299p
DHVASCGVNLYQFYGPSGQYTHEFDGDEQFYVDLERKETAWRWPEFSKFGGFDPQGALRNMAVAKHNLNIMIKRYNSTA/FVFQFKGMCYFTNGTERVRLVTRYIYNREEYARFDSDVGVYRAVTPQGRPDAEYWNSQKEVLEGTRAELDTVCRHNYEVAFRGILQRR/LVLDFCDDALIEGIT	proteinmpnn_test_binder_nonbinder/out/alignment/302p_with_pep.tsv	302p/302p
HVSTYAAFVQTHRPTGEFMFEFDEDEQFYVDLDKKETVWHLEEFGRAFSFEAQGGLANIAILNNNLNTLIQRSNHTQ/VHQLRQECYAFNGTQRFLERYIYNREEFVRFDSDVGEFRAVTELGRPDEDYWNSQKDLLEEKRAVPDRVCRHNYELDEAVTLQRR/YEAFVLHFSEALHII	proteinmpnn_test_binder_nonbinder/out/alignment/301p_with_pep.tsv	301p/301p
HVSTYAAFVQTHRPTGEFMFEFDEDEQFYVDLDKKETVWHLEEFGRAFSFEAQGGLANIAILNNNLNTLIQRSNHTQ/VHQLRQECYAFNGTQRFLERYIYNREEFVRFDSDVGEFRAVTELGRPDEDYWNSQKDLLEEKRAVPDRVCRHNYELDEAVTLQRR/AFKVAATAANAAPNN	proteinmpnn_test_binder_nonbinder/out/alignment/303p_with_pep.tsv	303p/303p
HVSTYAAFVQTHRPTGEFMFEFDEDEQFYVDLDKKETVWHLEEFGRAFSFEAQGGLANIAILNNNLNTLIQRSNHTQ/VHQLRQECYAFNGTQRFLERYIYNREEFVRFDSDVGEFRAVTELGRPDEDYWNSQKDLLEEKRAVPDRVCRHNYELDEAVTLQRR/EKKYFAATQLEPLAA	proteinmpnn_test_binder_nonbinder/out/alignment/304p_with_pep.tsv	304p/304p
HVSTYAAFVQTHRPTGEFMFEFDEDEMFYVDLDKKETVWHLEEFGQAFSFEAQGGLANIAILNNNLNTLIQRSNHTQ/VYQLRQECYAFNGTQRFLERYIYNREEFVRFDSDVGEFRAVTELGRPDEDYWNSQKDLLEEERAVPDRMCRHNYELDEAVTLQRR/EKPYFAATQFEPLAA	proteinmpnn_test_binder_nonbinder/out/alignment/305p_with_pep.tsv	305p/305p
HVSTYAMFVQTHRPTGEFMFEFDEDEMFYVDLDKKETVWHLEEFGQAFSFEAQGGLANIAISNNNLNTLIQRSNHTQ/LFQGRQECYAFNGTQRFLERYIYNREEFVRFDSDVGEFRAVTELGRPDEEYWNSQKDILEEKRAVPDRMCRHNYELGGPMTLQRR/TLTAFGFASADLIEI	proteinmpnn_test_binder_nonbinder/out/alignment/306p_with_pep.tsv	306p/306p
DHVASCGVNLYQFYGPSGQYTHEFDGDEQFYVDLERKETAWRWPEFSKFGGFDPQGALRNMAVAKHNLNIMIKRYNSTA/FVFQFKGMCYFTNGTERVRLVTRYIYNREEYARFDSDVGVYRAVTPQGRPDAEYWNSQKEVLEGTRAELDTVCRHNYEVAFRGILQRR/AAATAGTTIYGAFAA	proteinmpnn_test_binder_nonbinder/out/alignment/307p_with_pep.tsv	307p/307p
HVSTYAAFVQTHRPTGEFMFEFDEDEMFYVDLDKKETVWHLEEFGQAFSFEAQGGLANIAILNNNLNTLIQRSNHTQ/LFQGRQECYAFNGTQRFLERYIYNREEFARFDSDVGEFRAVTELGRPAAEYWNSQKDILEEKRAVPDRMCRHNYELGGPMTLQRR/GGFMTTAFQYIIDNKG	proteinmpnn_test_binder_nonbinder/out/alignment/308p_with_pep.tsv	308p/308p
HVSTYAAFVQTHRPTGEFMFEFDEDEMFYVDLDKKETVWHLEEFGQAFSFEAQGGLANIAILNNNLNTLIQRSNHTQ/LFQGRQECYAFNGTQRFLERYIYNREEFARFDSDVGEFRAVTELGRPAAEYWNSQKDILEEKRAVPDRMCRHNYELGGPMTLQRR/EKKYFYATQFEPLAA	proteinmpnn_test_binder_nonbinder/out/alignment/309p_with_pep.tsv	309p/309p
HVSTYAAFVQTHRPTGEFMFEFDEDEMFYVDLDKKETVWHLEEFGQAFSFEAQGGLANIAILNNNLNTLIQRSNHTQ/VYQLRQECYAFNGTQRFLERYIYNREEFVRFDSDVGEFRAVTELGRPDEDYWNSQKDLLEEERAVPDRMCRHNYELDEAVTLQRR/EKKYFAATQFEPLAA	proteinmpnn_test_binder_nonbinder/out/alignment/310p_with_pep.tsv	310p/310p
HVSTYAMFVQTHRPTGEFMFEFDEDEMFYVDLDKKETVWHLEEFGQAFSFEAQGGLANIAISNNNLNTLIQRSNHTQ/LFQGRQECYAFNGTQRFLERYIYNREEFVRFDSDVGEFRAVTELGRPDEEYWNSQKDILEEKRAVPDRMCRHNYELGGPMTLQRR/EKKYFAATQFEKLAA	proteinmpnn_test_binder_nonbinder/out/alignment/311p_with_pep.tsv	311p/311p
DHVASYGVNLYQSYGPSGQYTHEFDGDEQFYVDLGRKETVWCLPVLRQFRFDPQFALTNIAVLKHNLNSLIKRSNSTA/FVYQFKAMCYFTNGTERVRYVTRYIYNREEYARFDSDVEVYRAVTPLGPPDAEYWNSQKEVLERTRAELDTVCRHNYQLELRTTLQRR/AAPAAGYTPATPAAP	proteinmpnn_test_binder_nonbinder/out/alignment/312p_with_pep.tsv	312p/312p
HVSTYAAFVQTHRPTGEFMFEFDEDEMFYVDLDKKETVWHLEEFGQAFSFEAQGGLANIAILNNNLNTLIQRSNHTQ/VYQLRQECYAFNGTQRFLERYIYNREEFVRFDSDVGEFRAVTELGRPDEDYWNSQKDLLEEERAVPDRMCRHNYELDEAVTLQRR/EKKYFRATQFEPLAA	proteinmpnn_test_binder_nonbinder/out/alignment/313p_with_pep.tsv	313p/313p
HVSTYAMFVQTHRPTGEFMFEFDEDEMFYVDLDKKETVWHLEEFGQAFSFEAQGGLANIAISNNNLNTLIQRSNHTQ/LFQGRQECYAFNGTQRFLERYIYNREEFVRFDSDVGEFRAVTELGRPDEEYWNSQKDILEEKRAVPDRMCRHNYELGGPMTLQRR/EKKYFAATQFGPLAA	proteinmpnn_test_binder_nonbinder/out/alignment/314p_with_pep.tsv	314p/314p
DHVASYGVNLYQSYGPSGQYTHEFDGDEQFYVDLGRKETVWCLPVLRQFRFDPQFALTNIAVLKHNLNSLIKRSNSTA/FVYQFKAMCYFTNGTERVRYVTRYIYNREEYARFDSDVEVYRAVTPLGPPDAEYWNSQKEVLERTRAELDTVCRHNYQLELRTTLQRR/TATAAVGAATGAATA	proteinmpnn_test_binder_nonbinder/out/alignment/315p_with_pep.tsv	315p/315p
DHVASYGVNLYQSYGPSGQYSHEFDGDEEFYVDLERKETVWQLPLFRRFRRFDPQFALTNIAVLKHNLNIVIKRSNSTA/FVYQFKAMCYFTNGTERVRYVTRYIYNREEYARFDSDVEVYRAVTPLGPPDAEYWNSQKEVLERTRAELDTVCRHNYQLELRTTLQRR/GAVFLGFLGAAGSTMG	proteinmpnn_test_binder_nonbinder/out/alignment/316p_with_pep.tsv	316p/316p
HVSTYAAFVQTHRPTGEFMFEFDEDEMFYVDLDKKETVWHLEEFGQAFSFEAQGGLANIAILNNNLNTLIQRSNHTQ/VYQLRQECYAFNGTQRFLERYIYNREEFVRFDSDVGEFRAVTELGRPDEDYWNSQKDLLEEERAVPDRMCRHNYELDEAVTLQRR/ECKYFAATQFEPLAA	proteinmpnn_test_binder_nonbinder/out/alignment/317p_with_pep.tsv	317p/317p
HVSTYAAFVQTHRPTGEFMFEFDEDEQFYVDLDKKETVWHLEEFGRAFSFEAQGGLANIAILNNNLNTLIQRSNHTQ/VYQGRQECYAFNGTQRFLERYIYNREEYARFDSDVGEFRAVTELGRPAAEYWNSQKDILEEKRAVPDRVCRHNYELDEAVTLQRR/GVLKNEFMSLAFDYW	proteinmpnn_test_binder_nonbinder/out/alignment/318p_with_pep.tsv	318p/318p
HVSTYAMFVQTHRPTGEFMFEFDEDEMFYVDLDKKETVWHLEEFGQAFSFEAQGGLANIAISNNNLNTLIQRSNHTQ/LFQGRQECYAFNGTQRFLERYIYNREEFVRFDSDVGEFRAVTELGRPDEEYWNSQKDILEEKRAVPDRMCRHNYELGGPMTLQRR/EKKYFAATQFEPLAQ	proteinmpnn_test_binder_nonbinder/out/alignment/320p_with_pep.tsv	320p/320p
HVSTYAAFVQTHRPTGEFMFEFDEDEMFYVDLDKKETVWHLEEFGQAFSFEAQGGLANIAILNNNLNTLIQRSNHTQ/VYQLRQECYAFNGTQRFLERYIYNREEFVRFDSDVGEFRAVTELGRPDEDYWNSQKDLLEEERAVPDRMCRHNYELDEAVTLQRR/EKKYFAATQFEPLHA	proteinmpnn_test_binder_nonbinder/out/alignment/319p_with_pep.tsv	319p/319p
DHVASYGVNLYQSYGPSGQYTHEFDGDEQFYVDLGRKETVWCLPVLRQFRFDPQFALTNIAVLKHNLNSLIKRSNSTA/FVYQFKGMCYFTNGTERVRLVSRSIYNREEIVRFDSDVGEFRAVTLLGLPAAEYWNSQKDILERKRAAVDRVCRHNYQLELRTTLQRR/YSINNVMDEIDFFEK	proteinmpnn_test_binder_nonbinder/out/alignment/321p_with_pep.tsv	321p/321p
DHVASCGVNLYQFYGPSGQYTHEFDGDEQFYVDLERKETAWRWPEFSKFGGFDPQGALRNMAVAKHNLNIMIKRYNSTA/FVFQFKGMCYFTNGTERVRLVTRYIYNREEYARFDSDVGVYRAVTPQGRPDAEYWNSQKEVLEGTRAELDTVCRHNYEVAFRGILQRR/AARTAGTTVYGAFAA	proteinmpnn_test_binder_nonbinder/out/alignment/322p_with_pep.tsv	322p/322p
DHVASCGVNLYQFYGPSGQYTHEFDGDEQFYVDLERKETAWRWPEFSKFGGFDPQGALRNMAVAKHNLNIMIKRYNSTA/FVFQFKGMCYFTNGTERVRLVTRYIYNREEYARFDSDVGVYRAVTPQGRPDAEYWNSQKEVLEGTRAELDTVCRHNYEVAFRGILQRR/INENTAAAIAYGLDR	proteinmpnn_test_binder_nonbinder/out/alignment/323p_with_pep.tsv	323p/323p
HVSTYAAFVQTHRPTGEFMFEFDEDEQFYVDLDKKETVWHLEEFGRAFSFEAQGGLANIAILNNNLNTLIQRSNHTQ/VYQGRQECYAFNGTQRFLERYIYNREEYARFDSDVGEFRAVTELGRPAAEYWNSQKDILEEKRAVPDRVCRHNYELDEAVTLQRR/EKKYFAATQFEFLAA	proteinmpnn_test_binder_nonbinder/out/alignment/324p_with_pep.tsv	324p/324p
DHVASYGVNLYQSYGPSGQYTHEFDGDEQFYVDLGRKETVWCLPVLRQFRFDPQFALTNIAVLKHNLNSLIKRSNSTA/FVYQFKAMCYFTNGTERVRYVTRYIYNREEYARFDSDVEVYRAVTPLGPPDAEYWNSQKEVLERTRAELDTVCRHNYQLELRTTLQRR/DVKFYGGGQIVGGVY	proteinmpnn_test_binder_nonbinder/out/alignment/325p_with_pep.tsv	325p/325p
HVSTYAAFVQTHRPTGEFMFEFDEDEMFYVDLDKKETVWHLEEFGQAFSFEAQGGLANIAILNNNLNTLIQRSNHTQ/LFQGRQECYAFNGTQRFLERYIYNREEFARFDSDVGEFRAVTELGRPAAEYWNSQKDILEEKRAVPDRMCRHNYELGGPMTLQRR/EKKVFAATQFEPLAA	proteinmpnn_test_binder_nonbinder/out/alignment/326p_with_pep.tsv	326p/326p
DHVASCGVNLYQFYGPSGQYTHEFDGDEQFYVDLERKETAWRWPEFSKFGGFDPQGALRNMAVAKHNLNIMIKRYNSTA/FVFQFKGMCYFTNGTERVRLVTRYIYNREEYARFDSDVGVYRAVTPQGRPDAEYWNSQKEVLEGTRAELDTVCRHNYEVAFRGILQRR/RAATAGTTVYGAFAA	proteinmpnn_test_binder_nonbinder/out/alignment/327p_with_pep.tsv	327p/327p
DHVASYGVNLYQSYGPSGQFTHEFDGDEQFYVDLGRKETVWCLPVLRQFRFDPQFALTNIAVTKHNLNILIKRSNSTA/FVFQFKGMCYFTNGTERVRGVTRYIYNREEYARFDSDVGVYRAVTPLGRLDAEYWNSQKDILEEDRASVDTVCRHNYQLELRTTLQRR/LHGGHVSCRVKLSAL	proteinmpnn_test_binder_nonbinder/out/alignment/328p_with_pep.tsv	328p/328p
HVSTYAMFVQTHRPTGEFMFEFDEDEMFYVDLDKKETVWHLEEFGQAFSFEAQGGLANIAISNNNLNTLIQRSNHTQ/LFQGRQECYAFNGTQRFLERYIYNREEFVRFDSDVGEFRAVTELGRPDEEYWNSQKDILEEKRAVPDRMCRHNYELGGPMTLQRR/EKKYFAATQFEALAA	proteinmpnn_test_binder_nonbinder/out/alignment/329p_with_pep.tsv	329p/329p
HVSTYAAFVQTHRPTGEFMFEFDEDEQFYVDLDKKETVWHLEEFGRAFSFEAQGGLANIAILNNNLNTLIQRSNHTQ/VYQGRQECYAFNGTQRFLERYIYNREEYARFDSDVGEFRAVTELGRPAAEYWNSQKDILEEKRAVPDRVCRHNYELDEAVTLQRR/APEVKYTVFETALKE	proteinmpnn_test_binder_nonbinder/out/alignment/330p_with_pep.tsv	330p/330p
HVSTYAAFVQTHRPTGEFMFEFDEDEMFYVDLDKKETVWHLEEFGQAFSFEAQGGLANIAILNNNLNTLIQRSNHTQ/VYQLRQECYAFNGTQRFLERYIYNREEFVRFDSDVGEFRAVTELGRPDEDYWNSQKDLLEEERAVPDRMCRHNYELDEAVTLQRR/EKDYFAATQFEPLAA	proteinmpnn_test_binder_nonbinder/out/alignment/331p_with_pep.tsv	331p/331p
DHVASYGVNLYQSYGPSGQYTHEFDGDEQFYVDLGRKETVWCLPVLRQFRFDPQFALTNIAVLKHNLNSLIKRSNSTA/FVYQFKGMCYFTNGTERVRLVSRSIYNREEIVRFDSDVGEFRAVTLLGLPAAEYWNSQKDILERKRAAVDRVCRHNYQLELRTTLQRR/IDVWLGGLAENFLPY	proteinmpnn_test_binder_nonbinder/out/alignment/333p_with_pep.tsv	333p/333p
HVSTYAAFVQTHRPTGEFMFEFDEDEQFYVDLDKKETVWHLEEFGRAFSFEAQGGLANIAILNNNLNTLIQRSNHTQ/VYQGRQECYAFNGTQRFLERYIYNREEYARFDSDVGEFRAVTELGRPAAEYWNSQKDILEEKRAVPDRVCRHNYELDEAVTLQRR/PKKYFAATQFEPLAA	proteinmpnn_test_binder_nonbinder/out/alignment/332p_with_pep.tsv	332p/332p
HVSTYAAFVQTHRPTGEFMFEFDEDEMFYVDLDKKETVWHLEEFGQAFSFEAQGGLANIAILNNNLNTLIQRSNHTQ/VYQLRQECYAFNGTQRFLERYIYNREEFVRFDSDVGEFRAVTELGRPDEDYWNSQKDLLEEERAVPDRMCRHNYELDEAVTLQRR/IKKYFAATQFEPLAA	proteinmpnn_test_binder_nonbinder/out/alignment/334p_with_pep.tsv	334p/334p
DHVASYGVNLYQSYGPSGQYTHEFDGDEQFYVDLGRKETVWCLPVLRQFRFDPQFALTNIAVLKHNLNSLIKRSNSTA/FVFQFKGMCYFTNGTERVRGVTRYIYNREEYARFDSDVGVYRAVTPLGRLDAEYWNSQKDILEEDRASVDTVCRHNYQLELRTTLQRR/HTMWHVTRGAFLVRN	proteinmpnn_test_binder_nonbinder/out/alignment/335p_with_pep.tsv	335p/335p
HVSTYAAFVQTHRPTGEFMFEFDEDEMFYVDLDKKETVWHLEEFGQAFSFEAQGGLANIAILNNNLNTLIQRSNHTQ/LFQGRQECYAFNGTQRFLERYIYNREEFARFDSDVGEFRAVTELGRPAAEYWNSQKDILEEKRAVPDRMCRHNYELGGPMTLQRR/LPSQAFEYILYNKG	proteinmpnn_test_binder_nonbinder/out/alignment/336p_with_pep.tsv	336p/336p
HVSTYAAFVQTHRPTGEFMFEFDEDEQFYVDLDKKETVWHLEEFGRAFSFEAQGGLANIAILNNNLNTLIQRSNHTQ/LFQGRQECYAFNGTQRFLERYIYNREELVRFDSDVGEFRAVTELGRPEAEYWNSQKDILEEKRAVPDRMCRHNYELDEAVTLQRR/EKKYFAATQFEPLGA	proteinmpnn_test_binder_nonbinder/out/alignment/337p_with_pep.tsv	337p/337p
HVSTYAAFVQTHRPTGEFMFEFDEDEMFYVDLDKKETVWHLEEFGQAFSFEAQGGLANIAILNNNLNTLIQRSNHTQ/VYQLRQECYAFNGTQRFLERYIYNREEFVRFDSDVGEFRAVTELGRPDEDYWNSQKDLLEEERAVPDRMCRHNYELDEAVTLQRR/ERKYFAATQFEPLAA	proteinmpnn_test_binder_nonbinder/out/alignment/338p_with_pep.tsv	338p/338p
HVSTYAAFVQTHRPTGEFMFEFDEDEQFYVDLDKKETVWHLEEFGRAFSFEAQGGLANIAILNNNLNTLIQRSNHTQ/VHQLRQECYAFNGTQRFLERYIYNREEFVRFDSDVGEFRAVTELGRPDEDYWNSQKDLLEEKRAVPDRVCRHNYELDEAVTLQRR/AFKVAALAANAAPAN	proteinmpnn_test_binder_nonbinder/out/alignment/339p_with_pep.tsv	339p/339p
DHVASCGVNLYQFYGPSGQYTHEFDGDEQFYVDLERKETAWRWPEFSKFGGFDPQGALRNMAVAKHNLNIMIKRYNSTA/FVFQFKGMCYFTNGTERVRLVTRYIYNREEYARFDSDVGVYRAVTPQGRPDAEYWNSQKEVLEGTRAELDTVCRHNYEVAFRGILQRR/EAATAGTTVYGAFAA	proteinmpnn_test_binder_nonbinder/out/alignment/340p_with_pep.tsv	340p/340p
DHVASYGVNLYQSYGPSGQYTHEFDGDEQFYVDLGRKETVWCLPVLRQFRFDPQFALTNIAVLKHNLNSLIKRSNSTA/FVYQFKGMCYFTNGTERVRLVSRSIYNREEIVRFDSDVGEFRAVTLLGLPAAEYWNSQKDILERKRAAVDRVCRHNYQLELRTTLQRR/SVQVRGELAAEEVEV	proteinmpnn_test_binder_nonbinder/out/alignment/341p_with_pep.tsv	341p/341p
DHVASCGVNLYQFYGPSGQYTHEFDGDEEFYVDLERKETAWRWPEFSKFGGFDPQGALRNMAVAKHNLNIMIKRYNSTA/FVYQFKGLCYFTNGTERVRGVTRHIYNREEYVRFDSDVGVYRAVTPQGRPVAEYWNSQKEVLEGARASVDRVCRHNYEVAYRGILQRR/SQDLELSWNLQGLQAY	proteinmpnn_test_binder_nonbinder/out/alignment/342p_with_pep.tsv	342p/342p
DHVASCGVNLYQFYGPSGQYTHEFDGDEQFYVDLERKETAWRWPEFSKFGGFDPQGALRNMAVAKHNLNIMIKRYNSTA/FVFQFKGMCYFTNGTERVRLVTRYIYNREEYARFDSDVGVYRAVTPQGRPDAEYWNSQKEVLEGTRAELDTVCRHNYEVAFRGILQRR/INEPTAAFIAYGLDR	proteinmpnn_test_binder_nonbinder/out/alignment/343p_with_pep.tsv	343p/343p
HVSTYAMFVQTHRPTGEFMFEFDEDEMFYVDLDKKETVWHLEEFGQAFSFEAQGGLANIAISNNNLNTLIQRSNHTQ/LFQGRQECYAFNGTQRFLERYIYNREEFVRFDSDVGEFRAVTELGRPDEEYWNSQKDILEEKRAVPDRMCRHNYELGGPMTLQRR/AAGAQLLWQLPLLSI	proteinmpnn_test_binder_nonbinder/out/alignment/344p_with_pep.tsv	344p/344p
HVSTYAMFVQTHRPTGEFMFEFDEDEMFYVDLDKKETVWHLEEFGQAFSFEAQGGLANIAISNNNLNTLIQRSNHTQ/LFQGRQECYAFNGTQRFLERYIYNREEFVRFDSDVGEFRAVTELGRPDEEYWNSQKDILEEKRAVPDRMCRHNYELGGPMTLQRR/EDPLFQLVSKLYEVV	proteinmpnn_test_binder_nonbinder/out/alignment/345p_with_pep.tsv	345p/345p
HVSTYAAFVQTHRPTGEFMFEFDEDEMFYVDLDKKETVWHLEEFGQAFSFEAQGGLANIAILNNNLNTLIQRSNHTQ/LFQGRQECYAFNGTQRFLERYIYNREEFARFDSDVGEFRAVTELGRPAAEYWNSQKDILEEKRAVPDRMCRHNYELGGPMTLQRR/APSGRIVMELYADVV	proteinmpnn_test_binder_nonbinder/out/alignment/346p_with_pep.tsv	346p/346p
HVSTYAAFVQTHRPTGEFMFEFDEDEMFYVDLDKKETVWHLEEFGQAFSFEAQGGLANIAILNNNLNTLIQRSNHTQ/VYQLRQECYAFNGTQRFLERYIYNREEFVRFDSDVGEFRAVTELGRPDEDYWNSQKDLLEEERAVPDRMCRHNYELDEAVTLQRR/EKKYFAATQFEPLAW	proteinmpnn_test_binder_nonbinder/out/alignment/347p_with_pep.tsv	347p/347p
DHVASYGVNLYQSYGPSGQFTHEFDGDEEFYVDLERKETVWKLPLFHRLRFDPQFALTNIAVLKHNLNILIKRSNSTA/FVFQFKGMCYFTNGTERVRGVTRYIYNREEYARFDSDVGVYRAVTPLGRLDAEYWNSQKDILEEDRASVDTVCRHNYQLELRTTLQRR/YLGYVIRDLAAMDGG	proteinmpnn_test_binder_nonbinder/out/alignment/348p_with_pep.tsv	348p/348p
HVSTYAMFVQTHRPTGEFMFEFDEDEMFYVDLDKKETVWHLEEFGQAFSFEAQGGLANIAISNNNLNTLIQRSNHTQ/LFQGRQECYAFNGTQRFLERYIYNREEFVRFDSDVGEFRAVTELGRPDEEYWNSQKDILEEKRAVPDRMCRHNYELGGPMTLQRR/EKKYFAATQFEVLAA	proteinmpnn_test_binder_nonbinder/out/alignment/349p_with_pep.tsv	349p/349p
DHVASYGVNLYQSYGPSGQYTHEFDGDEQFYVDLGRKETVWCLPVLRQFRFDPQFALTNIAVLKHNLNSLIKRSNSTA/FVYQFKAMCYFTNGTERVRYVTRYIYNREEYARFDSDVEVYRAVTPLGPPDAEYWNSQKEVLERTRAELDTVCRHNYQLELRTTLQRR/DVKFPGGGQIVQGVY	proteinmpnn_test_binder_nonbinder/out/alignment/350p_with_pep.tsv	350p/350p
HVSTYAAFVQTHRPTGEFMFEFDEDEQFYVDLDKKETVWHLEEFGRAFSFEAQGGLANIAILNNNLNTLIQRSNHTQ/VYQGRQECYAFNGTQRFLERYIYNREEYARFDSDVGEFRAVTELGRPAAEYWNSQKDILEEKRAVPDRVCRHNYELDEAVTLQRR/HKKYFAATQFEPLAA	proteinmpnn_test_binder_nonbinder/out/alignment/351p_with_pep.tsv	351p/351p
DHVASCGVNLYQFYGPSGQYTHEFDGDEQFYVDLERKETAWRWPEFSKFGGFDPQGALRNMAVAKHNLNIMIKRYNSTA/FVFQFKGMCYFTNGTERVRLVTRYIYNREEYARFDSDVGVYRAVTPQGRPDAEYWNSQKEVLEGTRAELDTVCRHNYEVAFRGILQRR/TAATAGTTVYGAFAA	proteinmpnn_test_binder_nonbinder/out/alignment/352p_with_pep.tsv	352p/352p
DHVASYGVNLYQSYGPSGQYSHEFDGDEEFYVDLERKETVWQLPLFRRFRRFDPQFALTNIAVLKHNLNIVIKRSNSTA/FVYQFKGMCYFTNGTERVRLVTRYIYNREEYARFDSDVGVYRAVTPLGPPAAEYWNSQKEVLERTRAELDTVCRHNYQLELRTTLQRR/EEDIEIIPIQEEEY	proteinmpnn_test_binder_nonbinder/out/alignment/353p_with_pep.tsv	353p/353p
DHVASCGVNLYQFYGPSGQYTHEFDGDEEFYVDLERKETAWRWPEFSKFGGFDPQGALRNMAVAKHNLNIMIKRYNSTA/FVYQFKGLCYFTNGTERVRGVTRHIYNREEYVRFDSDVGVYRAVTPQGRPVAEYWNSQKEVLEGARASVDRVCRHNYEVAYRGILQRR/FLLSYGEKDFEDYRF	proteinmpnn_test_binder_nonbinder/out/alignment/354p_with_pep.tsv	354p/354p
HVSTYAMFVQTHRPTGEFMFEFDEDEMFYVDLDKKETVWHLEEFGQAFSFEAQGGLANIAISNNNLNTLIQRSNHTQ/LFQGRQECYAFNGTQRFLERYIYNREEFVRFDSDVGEFRAVTELGRPDEEYWNSQKDILEEKRAVPDRMCRHNYELGGPMTLQRR/KYFAATQFEPLAARL	proteinmpnn_test_binder_nonbinder/out/alignment/355p_with_pep.tsv	355p/355p
DHVASCGVNLYQFYGPSGQYTHEFDGDEQFYVDLERKETAWRWPEFSKFGGFDPQGALRNMAVAKHNLNIMIKRYNSTA/FVYQFKGLCYFTNGTERVRGVTRHIYNREEYVRFDSDVGVYRAVTPQGRPVAEYWNSQKEVLEGARASVDRVCRHNYEVAYRGILQRR/ILVTVNPIASTNDDE	proteinmpnn_test_binder_nonbinder/out/alignment/356p_with_pep.tsv	356p/356p
HVSTYAAFVQTHRPTGEFMFEFDEDEMFYVDLDKKETVWHLEEFGQAFSFEAQGGLANIAILNNNLNTLIQRSNHTQ/VYQLRQECYAFNGTQRFLERYIYNREEFVRFDSDVGEFRAVTELGRPDEDYWNSQKDLLEEERAVPDRMCRHNYELDEAVTLQRR/EKKYFAATQFEPLFA	proteinmpnn_test_binder_nonbinder/out/alignment/357p_with_pep.tsv	357p/357p
DHVASYGVNLYQSYGPSGQYTHEFDGDEQFYVDLGRKETVWCLPVLRQFRFDPQFALTNIAVLKHNLNSLIKRSNSTA/FVYQFKAMCYFTNGTERVRYVTRYIYNREEYARFDSDVEVYRAVTPLGPPDAEYWNSQKEVLERTRAELDTVCRHNYQLELRTTLQRR/YAIGGSSNPTILSEG	proteinmpnn_test_binder_nonbinder/out/alignment/358p_with_pep.tsv	358p/358p
HVSTYAAFVQTHRPTGEFMFEFDEDEMFYVDLDKKETVWHLEEFGQAFSFEAQGGLANIAILNNNLNTLIQRSNHTQ/LFQGRQECYAFNGTQRFLERYIYNREEFARFDSDVGEFRAVTELGRPAAEYWNSQKDILEEKRAVPDRMCRHNYELGGPMTLQRR/HFSNVFRSVMAPFTM	proteinmpnn_test_binder_nonbinder/out/alignment/359p_with_pep.tsv	359p/359p
HVSTYAAFVQTHRPTGEFMFEFDEDEMFYVDLDKKETVWHLEEFGQAFSFEAQGGLANIAILNNNLNTLIQRSNHTQ/VYQLRQECYAFNGTQRFLERYIYNREEFVRFDSDVGEFRAVTELGRPDEDYWNSQKDLLEEKRAVPDRVCRHNYELDEAVTLQRR/AFKVAATAAFAAPAN	proteinmpnn_test_binder_nonbinder/out/alignment/360p_with_pep.tsv	360p/360p
HVSTYAMFVQTHRPTGEFMFEFDEDEMFYVDLDKKETVWHLEEFGQAFSFEAQGGLANIAISNNNLNTLIQRSNHTQ/LFQGRQECYAFNGTQRFLERYIYNREEFVRFDSDVGEFRAVTELGRPDEEYWNSQKDILEEKRAVPDRMCRHNYELGGPMTLQRR/TKKYFAATQFEPLAA	proteinmpnn_test_binder_nonbinder/out/alignment/361p_with_pep.tsv	361p/361p
DHVASYGVNLYQSYGPSGQFTHEFDGDEEFYVDLERKETVWKLPLFHRLRFDPQFALTNIAVLKHNLNILIKRSNSTA/FVYQFKAMCYFTNGTERVRYVTRYIYNREEYARFDSDVEVYRAVTPLGPPDAEYWNSQKEVLERTRAELDTVCRHNYQLELRTTLQRR/VTKTSGSAASMVNGV	proteinmpnn_test_binder_nonbinder/out/alignment/362p_with_pep.tsv	362p/362p
DHVASCGVNLYQFYGPSGQYTHEFDGDEQFYVDLERKETAWRWPEFSKFGGFDPQGALRNMAVAKHNLNIMIKRYNSTA/FVFQFKGMCYFTNGTERVRLVTRYIYNREEYARFDSDVGVYRAVTPQGRPDAEYWNSQKEVLEGTRAELDTVCRHNYEVAFRGILQRR/AFATAGTTVYGAFAA	proteinmpnn_test_binder_nonbinder/out/alignment/364p_with_pep.tsv	364p/364p
DHVASYGVNLYQSYGPSGQYTHEFDGDEQFYVDLGRKETVWCLPVLRQFRFDPQFALTNIAVLKHNLNSLIKRSNSTA/FVYQFKGMCYFTNGTERVRLVSRSIYNREEIVRFDSDVGEFRAVTLLGLPAAEYWNSQKDILERKRAAVDRVCRHNYQLELRTTLQRR/AFILDGDNLFPGV	proteinmpnn_test_binder_nonbinder/out/alignment/363p_with_pep.tsv	363p/363p
HVSTYAAFVQTHRPTGEFMFEFDEDEQFYVDLDKKETVWHLEEFGRAFSFEAQGGLANIAILNNNLNTLIQRSNHTQ/LFQGRQECYAFNGTQRFLERYIYNREELVRFDSDVGEFRAVTELGRPEAEYWNSQKDILEEKRAVPDRMCRHNYELDEAVTLQRR/EKKYFAATQFEPLLA	proteinmpnn_test_binder_nonbinder/out/alignment/365p_with_pep.tsv	365p/365p
HVSTYAAFVQTHRPTGEFMFEFDEDEQFYVDLDKKETVWHLEEFGRAFSFEAQGGLANIAILNNNLNTLIQRSNHTQ/VYQGRQECYAFNGTQRFLERYIYNREEYARFDSDVGEFRAVTELGRPAAEYWNSQKDILEEKRAVPDRVCRHNYELDEAVTLQRR/EKKYFAGTQFEPLAA	proteinmpnn_test_binder_nonbinder/out/alignment/366p_with_pep.tsv	366p/366p
HVSTYAAFVQTHRPTGEFMFEFDEDEMFYVDLDKKETVWHLEEFGQAFSFEAQGGLANIAILNNNLNTLIQRSNHTQ/VYQLRQECYAFNGTQRFLERYIYNREEFVRFDSDVGEFRAVTELGRPDEDYWNSQKDLLEEERAVPDRMCRHNYELDEAVTLQRR/EKKYFAATQFEPMAA	proteinmpnn_test_binder_nonbinder/out/alignment/367p_with_pep.tsv	367p/367p
HVSTYAAFVQTHRPTGEFMFEFDEDEMFYVDLDKKETVWHLEEFGQAFSFEAQGGLANIAILNNNLNTLIQRSNHTQ/VYQLRQECYAFNGTQRFLERYIYNREEFVRFDSDVGEFRAVTELGRPDEDYWNSQKDLLEEKRAVPDRVCRHNYELDEAVTLQRR/AFRVAATAANAAPAN	proteinmpnn_test_binder_nonbinder/out/alignment/368p_with_pep.tsv	368p/368p
HVSTYAAFVQTHRPTGEFMFEFDEDEMFYVDLDKKETVWHLEEFGQAFSFEAQGGLANIAILNNNLNTLIQRSNHTQ/LFQGRQECYAFNGTQRFLERYIYNREEFARFDSDVGEFRAVTELGRPAAEYWNSQKDILEEKRAVPDRMCRHNYELGGPMTLQRR/EKKYFDATQFEPLAA	proteinmpnn_test_binder_nonbinder/out/alignment/369p_with_pep.tsv	369p/369p
HVSTYAMFVQTHRPTGEFMFEFDEDEMFYVDLDKKETVWHLEEFGQAFSFEAQGGLANIAISNNNLNTLIQRSNHTQ/LFQGRQECYAFNGTQRFLERYIYNREEFVRFDSDVGEFRAVTELGRPDEEYWNSQKDILEEKRAVPDRMCRHNYELGGPMTLQRR/NSLLTSPLSINTRMT	proteinmpnn_test_binder_nonbinder/out/alignment/370p_with_pep.tsv	370p/370p
HVSTYAAFVQTHRPTGEFMFEFDEDEMFYVDLDKKETVWHLEEFGQAFSFEAQGGLANIAILNNNLNTLIQRSNHTQ/VYQLRQECYAFNGTQRFLERYIYNREEFVRFDSDVGEFRAVTELGRPDEDYWNSQKDLLEEERAVPDRMCRHNYELDEAVTLQRR/EKKYFAWTQFEPLAA	proteinmpnn_test_binder_nonbinder/out/alignment/371p_with_pep.tsv	371p/371p
DHVASCGVNLYQFYGPSGQYTHEFDGDEEFYVDLERKETAWRWPEFSKFGGFDPQGALRNMAVAKHNLNIMIKRYNSTA/FVYQFKGLCYFTNGTERVRGVTRHIYNREEYVRFDSDVGVYRAVTPQGRPVAEYWNSQKEVLEGARASVDRVCRHNYEVAYRGILQRR/NLDVYDWSIPDDLLA	proteinmpnn_test_binder_nonbinder/out/alignment/372p_with_pep.tsv	372p/372p
DHVASCGVNLYQFYGPSGQYTHEFDGDEEFYVDLERKETAWRWPEFSKFGGFDPQGALRNMAVAKHNLNIMIKRYNSTA/FVYQFKGLCYFTNGTERVRGVTRHIYNREEYVRFDSDVGVYRAVTPQGRPVAEYWNSQKEVLEGARASVDRVCRHNYEVAYRGILQRR/EKKYFAATFFEPLAA	proteinmpnn_test_binder_nonbinder/out/alignment/373p_with_pep.tsv	373p/373p
HVSTYAAFVQTHRPTGEFMFEFDEDEMFYVDLDKKETVWHLEEFGQAFSFEAQGGLANIAILNNNLNTLIQRSNHTQ/VYQLRQECYAFNGTQRFLERYIYNREEFVRFDSDVGEFRAVTELGRPDEDYWNSQKDLLEEERAVPDRMCRHNYELDEAVTLQRR/EKKYFAATQFEPLPA	proteinmpnn_test_binder_nonbinder/out/alignment/374p_with_pep.tsv	374p/374p
HVSTYAMFVQTHRPTGEFMFEFDEDEMFYVDLDKKETVWHLEEFGQAFSFEAQGGLANIAISNNNLNTLIQRSNHTQ/LFQGRQECYAFNGTQRFLERYIYNREEFVRFDSDVGEFRAVTELGRPDEEYWNSQKDILEEKRAVPDRMCRHNYELGGPMTLQRR/EKKYFASTQFEPLAA	proteinmpnn_test_binder_nonbinder/out/alignment/375p_with_pep.tsv	375p/375p
HVSTYAMFVQTHRPTGEFMFEFDEDEMFYVDLDKKETVWHLEEFGQAFSFEAQGGLANIAISNNNLNTLIQRSNHTQ/LFQGRQECYAFNGTQRFLERYIYNREEFVRFDSDVGEFRAVTELGRPDEEYWNSQKDILEEKRAVPDRMCRHNYELGGPMTLQRR/EKKYFAATQFMPLAA	proteinmpnn_test_binder_nonbinder/out/alignment/376p_with_pep.tsv	376p/376p
HVSTYAAFVQTHRPTGEFMFEFDEDEMFYVDLDKKETVWHLEEFGQAFSFEAQGGLANIAILNNNLNTLIQRSNHTQ/LFQGRQECYAFNGTQRFLERYIYNREEFARFDSDVGEFRAVTELGRPAAEYWNSQKDILEEKRAVPDRMCRHNYELGGPMTLQRR/EKKAFAATQFEPLAA	proteinmpnn_test_binder_nonbinder/out/alignment/377p_with_pep.tsv	377p/377p
HVSTYAAFVQTHRPTGEFMFEFDEDEMFYVDLDKKETVWHLEEFGQAFSFEAQGGLANIAILNNNLNTLIQRSNHTQ/VYQLRQECYAFNGTQRFLERYIYNREEFVRFDSDVGEFRAVTELGRPDEDYWNSQKDLLEEERAVPDRMCRHNYELDEAVTLQRR/EKKYFDATQFEPLAA	proteinmpnn_test_binder_nonbinder/out/alignment/378p_with_pep.tsv	378p/378p
HVSTYAAFVQTHRPTGEFMFEFDEDEQFYVDLDKKETVWHLEEFGRAFSFEAQGGLANIAILNNNLNTLIQRSNHTQ/LFQGRQECYAFNGTQRFLERYIYNREELVRFDSDVGEFRAVTELGRPEAEYWNSQKDILEEKRAVPDRMCRHNYELDEAVTLQRR/EKKYFAATQFEFLAA	proteinmpnn_test_binder_nonbinder/out/alignment/379p_with_pep.tsv	379p/379p
HVSTYAMFVQTHRPTGEFMFEFDEDEMFYVDLDKKETVWHLEEFGQAFSFEAQGGLANIAISNNNLNTLIQRSNHTQ/LFQGRQECYAFNGTQRFLERYIYNREEFVRFDSDVGEFRAVTELGRPDEEYWNSQKDILEEKRAVPDRMCRHNYELGGPMTLQRR/EWKYFAATQFEPLAA	proteinmpnn_test_binder_nonbinder/out/alignment/380p_with_pep.tsv	380p/380p
HVSTYAAFVQTHRPTGEFMFEFDEDEQFYVDLDKKETVWHLEEFGRAFSFEAQGGLANIAILNNNLNTLIQRSNHTQ/VHQLRQECYAFNGTQRFLERYIYNREEFVRFDSDVGEFRAVTELGRPDEDYWNSQKDLLEEKRAVPDRVCRHNYELDEAVTLQRR/AFKVAATAANAAP	proteinmpnn_test_binder_nonbinder/out/alignment/381p_with_pep.tsv	381p/381p
HVSTYAAFVQTHRPTGEFMFEFDEDEQFYVDLDKKETVWHLEEFGRAFSFEAQGGLANIAILNNNLNTLIQRSNHTQ/VHQLRQECYAFNGTQRFLERYIYNREEFVRFDSDVGEFRAVTELGRPDEDYWNSQKDLLEEKRAVPDRVCRHNYELDEAVTLQRR/AKKYFAATQFEPLAA	proteinmpnn_test_binder_nonbinder/out/alignment/382p_with_pep.tsv	382p/382p
HVSTYAAFVQTHRPTGEFMFEFDEDEQFYVDLDKKETVWHLEEFGRAFSFEAQGGLANIAILNNNLNTLIQRSNHTQ/LFQGRQECYAFNGTQRFLERYIYNREELVRFDSDVGEFRAVTELGRPEAEYWNSQKDILEEKRAVPDRMCRHNYELDEAVTLQRR/EKKYFAFTQFEPLAA	proteinmpnn_test_binder_nonbinder/out/alignment/383p_with_pep.tsv	383p/383p
HVSTYAAFVQTHRPTGEFMFEFDEDEQFYVDLDKKETVWHLEEFGRAFSFEAQGGLANIAILNNNLNTLIQRSNHTQ/LFQGRQECYAFNGTQRFLERYIYNREELVRFDSDVGEFRAVTELGRPEAEYWNSQKDILEEKRAVPDRMCRHNYELDEAVTLQRR/GGSILKISNKFHTKG	proteinmpnn_test_binder_nonbinder/out/alignment/384p_with_pep.tsv	384p/384p
HVSTYAAFVQTHRPTGEFMFEFDEDEMFYVDLDKKETVWHLEEFGQAFSFEAQGGLANIAILNNNLNTLIQRSNHTQ/LFQGRQECYAFNGTQRFLERYIYNREEFARFDSDVGEFRAVTELGRPAAEYWNSQKDILEEKRAVPDRMCRHNYELGGPMTLQRR/ELFVAAYVPYVAWLV	proteinmpnn_test_binder_nonbinder/out/alignment/385p_with_pep.tsv	385p/385p
DHVASYGVNLYQSYGPSGQFTHEFDGDEEFYVDLERKETVWKLPLFHRLRFDPQFALTNIAVLKHNLNILIKRSNSTA/FVFQFKGMCYFTNGTERVRGVTRYIYNREEYARFDSDVGVYRAVTPLGRLDAEYWNSQKDILEEDRASVDTVCRHNYQLELRTTLQRR/TKPSLFKVRNGGEIG	proteinmpnn_test_binder_nonbinder/out/alignment/386p_with_pep.tsv	386p/386p
HVSTYAAFVQTHRPTGEFMFEFDEDEQFYVDLDKKETVWHLEEFGRAFSFEAQGGLANIAILNNNLNTLIQRSNHTQ/LFQGRQECYAFNGTQRFLERYIYNREELVRFDSDVGEFRAVTELGRPEAEYWNSQKDILEEKRAVPDRMCRHNYELDEAVTLQRR/EKKYFASTQFEPLAA	proteinmpnn_test_binder_nonbinder/out/alignment/387p_with_pep.tsv	387p/387p
DHVASYGVNLYQSYGPSGQYTHEFDGDEQFYVDLGRKETVWCLPVLRQFRFDPQFALTNIAVLKHNLNSLIKRSNSTA/FVYQFKAMCYFTNGTERVRYVTRYIYNREEYARFDSDVEVYRAVTPLGPPDAEYWNSQKEVLERTRAELDTVCRHNYQLELRTTLQRR/DVFFPGGGQIVGGVY	proteinmpnn_test_binder_nonbinder/out/alignment/390p_with_pep.tsv	390p/390p
HVSTYAAFVQTHRPTGEFMFEFDEDEMFYVDLDKKETVWHLEEFGQAFSFEAQGGLANIAILNNNLNTLIQRSNHTQ/VYQLRQECYAFNGTQRFLERYIYNREEFVRFDSDVGEFRAVTELGRPDEDYWNSQKDLLEEERAVPDRMCRHNYELDEAVTLQRR/EKKYFWATQFEPLAA	proteinmpnn_test_binder_nonbinder/out/alignment/388p_with_pep.tsv	388p/388p
HVSTYAAFVQTHRPTGEFMFEFDEDEMFYVDLDKKETVWHLEEFGQAFSFEAQGGLANIAILNNNLNTLIQRSNHTQ/VYQLRQECYAFNGTQRFLERYIYNREEFVRFDSDVGEFRAVTELGRPDEDYWNSQKDLLEEERAVPDRMCRHNYELDEAVTLQRR/EKKYFAATQFEPLCA	proteinmpnn_test_binder_nonbinder/out/alignment/389p_with_pep.tsv	389p/389p
DHVASYGVNLYQSYGPSGQYTHEFDGDEQFYVDLGRKETVWCLPVLRQFRFDPQFALTNIAVLKHNLNSLIKRSNSTA/FVFQFKGMCYFTNGTERVRGVTRYIYNREEYARFDSDVGVYRAVTPLGRLDAEYWNSQKDILEEDRASVDTVCRHNYQLELRTTLQRR/HVTRGAFLVRNGKKL	proteinmpnn_test_binder_nonbinder/out/alignment/392p_with_pep.tsv	392p/392p
HVSTYAAFVQTHRPTGEFMFEFDEDEMFYVDLDKKETVWHLEEFGQAFSFEAQGGLANIAILNNNLNTLIQRSNHTQ/VYQLRQECYAFNGTQRFLERYIYNREEFVRFDSDVGEFRAVTELGRPDEDYWNSQKDLLEEERAVPDRMCRHNYELDEAVTLQRR/EKKYFAATQFEPLMA	proteinmpnn_test_binder_nonbinder/out/alignment/393p_with_pep.tsv	393p/393p
HVSTYAAFVQTHRPTGEFMFEFDEDEQFYVDLDKKETVWHLEEFGRAFSFEAQGGLANIAILNNNLNTLIQRSNHTQ/VYQGRQECYAFNGTQRFLERYIYNREEYARFDSDVGEFRAVTELGRPAAEYWNSQKDILEEKRAVPDRVCRHNYELDEAVTLQRR/EKKYFAATQFEILAA	proteinmpnn_test_binder_nonbinder/out/alignment/391p_with_pep.tsv	391p/391p
HVSTYAMFVQTHRPTGEFMFEFDEDEMFYVDLDKKETVWHLEEFGQAFSFEAQGGLANIAISNNNLNTLIQRSNHTQ/LFQGRQECYAFNGTQRFLERYIYNREEFVRFDSDVGEFRAVTELGRPDEEYWNSQKDILEEKRAVPDRMCRHNYELGGPMTLQRR/ELFVAAYVPYVAWLV	proteinmpnn_test_binder_nonbinder/out/alignment/396p_with_pep.tsv	396p/396p
HVSTYAAFVQTHRPTGEFMFEFDEDEMFYVDLDKKETVWHLEEFGQAFSFEAQGGLANIAILNNNLNTLIQRSNHTQ/LFQGRQECYAFNGTQRFLERYIYNREEFARFDSDVGEFRAVTELGRPAAEYWNSQKDILEEKRAVPDRMCRHNYELGGPMTLQRR/EKKYFAATQFTPLAA	proteinmpnn_test_binder_nonbinder/out/alignment/394p_with_pep.tsv	394p/394p
HVSTYAAFVQTHRPTGEFMFEFDEDEMFYVDLDKKETVWHLEEFGQAFSFEAQGGLANIAILNNNLNTLIQRSNHTQ/VYQLRQECYAFNGTQRFLERYIYNREEFVRFDSDVGEFRAVTELGRPDEDYWNSQKDLLEEERAVPDRMCRHNYELDEAVTLQRR/EKKYFAATQFEPWAA	proteinmpnn_test_binder_nonbinder/out/alignment/395p_with_pep.tsv	395p/395p
HVSTYAAFVQTHRPTGEFMFEFDEDEMFYVDLDKKETVWHLEEFGQAFSFEAQGGLANIAILNNNLNTLIQRSNHTQ/VYQLRQECYAFNGTQRFLERYIYNREEFVRFDSDVGEFRAVTELGRPDEDYWNSQKDLLEEKRAVPDRVCRHNYELDEAVTLQRR/AFKVYATAANAAPAN	proteinmpnn_test_binder_nonbinder/out/alignment/398p_with_pep.tsv	398p/398p
HVSTYAAFVQTHRPTGEFMFEFDEDEMFYVDLDKKETVWHLEEFGQAFSFEAQGGLANIAILNNNLNTLIQRSNHTQ/LFQGRQECYAFNGTQRFLERYIYNREEFARFDSDVGEFRAVTELGRPAAEYWNSQKDILEEKRAVPDRMCRHNYELGGPMTLQRR/EKKYFAATQFEPLAN	proteinmpnn_test_binder_nonbinder/out/alignment/397p_with_pep.tsv	397p/397p
HVSTYAMFVQTHRPTGEFMFEFDEDEMFYVDLDKKETVWHLEEFGQAFSFEAQGGLANIAISNNNLNTLIQRSNHTQ/LFQGRQECYAFNGTQRFLERYIYNREEFVRFDSDVGEFRAVTELGRPDEEYWNSQKDILEEKRAVPDRMCRHNYELGGPMTLQRR/EKKYFAATQFWPLAA	proteinmpnn_test_binder_nonbinder/out/alignment/399p_with_pep.tsv	399p/399p
DHVASYGVNLYQSYGPSGQYTHEFDGDEQFYVDLGRKETVWCLPVLRQFRFDPQFALTNIAVLKHNLNSLIKRSNSTA/FVYQFKAMCYFTNGTERVRYVTRYIYNREEYARFDSDVEVYRAVTPLGPPDAEYWNSQKEVLERTRAELDTVCRHNYQLELRTTLQRR/AAFKIAATAANSAPA	proteinmpnn_test_binder_nonbinder/out/alignment/401p_with_pep.tsv	401p/401p
DHVASYGVNLYQSYGPSGQYSHEFDGDEEFYVDLERKETVWQLPLFRRFRRFDPQFALTNIAVLKHNLNIVIKRSNSTA/FVYQFKGMCYFTNGTERVRLVTRYIYNREEYARFDSDVGVYRAVTPLGPPAAEYWNSQKEVLERTRAELDTVCRHNYQLELRTTLQRR/GKWYLKAMTADQEVPE	proteinmpnn_test_binder_nonbinder/out/alignment/400p_with_pep.tsv	400p/400p
DHVASCGVNLYQFYGPSGQYTHEFDGDEQFYVDLERKETAWRWPEFSKFGGFDPQGALRNMAVAKHNLNIMIKRYNSTA/FVYQFKGLCYFTNGTERVRGVTRHIYNREEYVRFDSDVGVYRAVTPQGRPSAEYWNSQKEVLEGARASVDRVCRHNYEVAYRGILQRR/EATTDGLGWYKIEID	proteinmpnn_test_binder_nonbinder/out/alignment/402p_with_pep.tsv	402p/402p
HVSTYAAFVQTHRPTGEFMFEFDEDEMFYVDLDKKETVWHLEEFGQAFSFEAQGGLANIAILNNNLNTLIQRSNHTQ/LFQGRQECYAFNGTQRFLERYIYNREEFARFDSDVGEFRAVTELGRPAAEYWNSQKDILEEKRAVPDRMCRHNYELGGPMTLQRR/EKKYFAATQFEPLAT	proteinmpnn_test_binder_nonbinder/out/alignment/403p_with_pep.tsv	403p/403p
HVSTYAAFVQTHRPTGEFMFEFDEDEMFYVDLDKKETVWHLEEFGQAFSFEAQGGLANIAILNNNLNTLIQRSNHTQ/VYQLRQECYAFNGTQRFLERYIYNREEFVRFDSDVGEFRAVTELGRPDEDYWNSQKDLLEEERAVPDRMCRHNYELDEAVTLQRR/PKKYFAATQFEPLAA	proteinmpnn_test_binder_nonbinder/out/alignment/404p_with_pep.tsv	404p/404p
HVSTYAAFVQTHRPTGEFMFEFDEDEMFYVDLDKKETVWHLEEFGQAFSFEAQGGLANIAILNNNLNTLIQRSNHTQ/VYQLRQECYAFNGTQRFLERYIYNREEFVRFDSDVGEFRAVTELGRPDEDYWNSQKDLLEEERAVPDRMCRHNYELDEAVTLQRR/EKKYFAATQFEYLAA	proteinmpnn_test_binder_nonbinder/out/alignment/405p_with_pep.tsv	405p/405p
DHVASCGVNLYQFYGPSGQYTHEFDGDEQFYVDLERKETAWRWPEFSKFGGFDPQGALRNMAVAKHNLNIMIKRYNSTA/FVFQFKGMCYFTNGTERVRLVTRYIYNREEYARFDSDVGVYRAVTPQGRPDAEYWNSQKEVLEGTRAELDTVCRHNYEVAFRGILQRR/INEPMAAAIAYGLDR	proteinmpnn_test_binder_nonbinder/out/alignment/406p_with_pep.tsv	406p/406p
HVSTYAMFVQTHRPTGEFMFEFDEDEMFYVDLDKKETVWHLEEFGQAFSFEAQGGLANIAISNNNLNTLIQRSNHTQ/LFQGRQECYAFNGTQRFLERYIYNREEFVRFDSDVGEFRAVTELGRPDEEYWNSQKDILEEKRAVPDRMCRHNYELGGPMTLQRR/PKKYFAATQFEPLAA	proteinmpnn_test_binder_nonbinder/out/alignment/407p_with_pep.tsv	407p/407p
HVSTYAAFVQTHRPTGEFMFEFDEDEQFYVDLDKKETVWHLEEFGRAFSFEAQGGLANIAILNNNLNTLIQRSNHTQ/VHQLRQECYAFNGTQRFLERYIYNREEFVRFDSDVGEFRAVTELGRPDEDYWNSQKDLLEEKRAVPDRVCRHNYELDEAVTLQRR/NCVLKKSTNGLRIKS	proteinmpnn_test_binder_nonbinder/out/alignment/408p_with_pep.tsv	408p/408p
HVSTYAAFVQTHRPTGEFMFEFDEDEMFYVDLDKKETVWHLEEFGQAFSFEAQGGLANIAILNNNLNTLIQRSNHTQ/VYQLRQECYAFNGTQRFLERYIYNREEFVRFDSDVGEFRAVTELGRPDEDYWNSQKDLLEEERAVPDRMCRHNYELDEAVTLQRR/EKKYFYATQFEPLAA	proteinmpnn_test_binder_nonbinder/out/alignment/409p_with_pep.tsv	409p/409p
HVSTYAAFVQTHRPTGEFMFEFDEDEMFYVDLDKKETVWHLEEFGQAFSFEAQGGLANIAILNNNLNTLIQRSNHTQ/VYQLRQECYAFNGTQRFLERYIYNREEFVRFDSDVGEFRAVTELGRPDEDYWNSQKDLLEEERAVPDRMCRHNYELDEAVTLQRR/EKKYFAATQFEPLEA	proteinmpnn_test_binder_nonbinder/out/alignment/410p_with_pep.tsv	410p/410p
DHVASCGVNLYQFYGPSGQYTHEFDGDEQFYVDLERKETAWRWPEFSKFGGFDPQGALRNMAVAKHNLNIMIKRYNSTA/FVFQFKGMCYFTNGTERVRLVTRYIYNREEYARFDSDVGVYRAVTPQGRPDAEYWNSQKEVLEGTRAELDTVCRHNYEVAFRGILQRR/MPPELNTARLMAGAG	proteinmpnn_test_binder_nonbinder/out/alignment/411p_with_pep.tsv	411p/411p
HVSTYAAFVQTHRPTGEFMFEFDEDEQFYVDLDKKETVWHLEEFGRAFSFEAQGGLANIAILNNNLNTLIQRSNHTQ/VYQGRQECYAFNGTQRFLERYIYNREEYARFDSDVGEFRAVTELGRPAAEYWNSQKDILEEKRAVPDRVCRHNYELDEAVTLQRR/GKAGCQTYKWETFLT	proteinmpnn_test_binder_nonbinder/out/alignment/412p_with_pep.tsv	412p/412p
HVSTYAAFVQTHRPTGEFMFEFDEDEQFYVDLDKKETVWHLEEFGRAFSFEAQGGLANIAILNNNLNTLIQRSNHTQ/LFQGRQECYAFNGTQRFLERYIYNREELVRFDSDVGEFRAVTELGRPEAEYWNSQKDILEEKRAVPDRMCRHNYELDEAVTLQRR/EKKYFAATQFEPVAA	proteinmpnn_test_binder_nonbinder/out/alignment/413p_with_pep.tsv	413p/413p
HVSTYAAFVQTHRPTGEFMFEFDEDEQFYVDLDKKETVWHLEEFGRAFSFEAQGGLANIAILNNNLNTLIQRSNHTQ/VHQLRQECYAFNGTQRFLERYIYNREEFVRFDSDVGEFRAVTELGRPDEDYWNSQKDLLEEKRAVPDRVCRHNYELDEAVTLQRR/ADKVAYALAQGLKVI	proteinmpnn_test_binder_nonbinder/out/alignment/414p_with_pep.tsv	414p/414p
HVSTYAAFVQTHRPTGEFMFEFDEDEMFYVDLDKKETVWHLEEFGQAFSFEAQGGLANIAILNNNLNTLIQRSNHTQ/VYQLRQECYAFNGTQRFLERYIYNREEFVRFDSDVGEFRAVTELGRPDEDYWNSQKDLLEEERAVPDRMCRHNYELDEAVTLQRR/EKKYFAAWQFEPLAA	proteinmpnn_test_binder_nonbinder/out/alignment/415p_with_pep.tsv	415p/415p
HVSTYAAFVQTHRPTGEFMFEFDEDEMFYVDLDKKETVWHLEEFGQAFSFEAQGGLANIAILNNNLNTLIQRSNHTQ/LFQGRQECYAFNGTQRFLERYIYNREEFARFDSDVGEFRAVTELGRPAAEYWNSQKDILEEKRAVPDRMCRHNYELGGPMTLQRR/LQSLVSQYFQTVADY	proteinmpnn_test_binder_nonbinder/out/alignment/416p_with_pep.tsv	416p/416p
HVSTYAAFVQTHRPTGEFMFEFDEDEMFYVDLDKKETVWHLEEFGQAFSFEAQGGLANIAILNNNLNTLIQRSNHTQ/VYQLRQECYAFNGTQRFLERYIYNREEFVRFDSDVGEFRAVTELGRPDEDYWNSQKDLLEEERAVPDRMCRHNYELDEAVTLQRR/EKKYFAPTQFEPLAA	proteinmpnn_test_binder_nonbinder/out/alignment/417p_with_pep.tsv	417p/417p
DHVASCGVNLYQFYGPSGQYTHEFDGDEQFYVDLERKETAWRWPEFSKFGGFDPQGALRNMAVAKHNLNIMIKRYNSTA/FVFQFKGMCYFTNGTERVRLVTRYIYNREEYARFDSDVGVYRAVTPQGRPDAEYWNSQKEVLEGTRAELDTVCRHNYEVAFRGILQRR/INDPTAAAIAYGLDR	proteinmpnn_test_binder_nonbinder/out/alignment/418p_with_pep.tsv	418p/418p
HVSTYAAFVQTHRPTGEFMFEFDEDEQFYVDLDKKETVWHLEEFGRAFSFEAQGGLANIAILNNNLNTLIQRSNHTQ/LFQGRQECYAFNGTQRFLERYIYNREELVRFDSDVGEFRAVTELGRPEAEYWNSQKDILEEKRAVPDRMCRHNYELDEAVTLQRR/EKKYFAATQFEPLAL	proteinmpnn_test_binder_nonbinder/out/alignment/419p_with_pep.tsv	419p/419p
HVSTYAAFVQTHRPTGEFMFEFDEDEQFYVDLDKKETVWHLEEFGRAFSFEAQGGLANIAILNNNLNTLIQRSNHTQ/VYQGRQECYAFNGTQRFLERYIYNREEYARFDSDVGEFRAVTELGRPAAEYWNSQKDILEEKRAVPDRVCRHNYELDEAVTLQRR/RKKYFAATQFEPLAA	proteinmpnn_test_binder_nonbinder/out/alignment/420p_with_pep.tsv	420p/420p
HVSTYAMFVQTHRPTGEFMFEFDEDEMFYVDLDKKETVWHLEEFGQAFSFEAQGGLANIAISNNNLNTLIQRSNHTQ/LFQGRQECYAFNGTQRFLERYIYNREEFVRFDSDVGEFRAVTELGRPDEEYWNSQKDILEEKRAVPDRMCRHNYELGGPMTLQRR/EKKYFAATAFEPLAA	proteinmpnn_test_binder_nonbinder/out/alignment/421p_with_pep.tsv	421p/421p
DHVASCGVNLYQFYGPSGQYTHEFDGDEQFYVDLERKETAWRWPEFSKFGGFDPQGALRNMAVAKHNLNIMIKRYNSTA/FVFQFKGMCYFTNGTERVRLVTRYIYNREEYARFDSDVGVYRAVTPQGRPDAEYWNSQKEVLEGTRAELDTVCRHNYEVAFRGILQRR/ACATAGTTVYGAFAA	proteinmpnn_test_binder_nonbinder/out/alignment/422p_with_pep.tsv	422p/422p
DHVASCGVNLYQFYGPSGQYTHEFDGDEQFYVDLERKETAWRWPEFSKFGGFDPQGALRNMAVAKHNLNIMIKRYNSTA/FVFQFKGMCYFTNGTERVRLVTRYIYNREEYARFDSDVGVYRAVTPQGRPDAEYWNSQKEVLEGTRAELDTVCRHNYEVAFRGILQRR/INEPTAAAIAYGLDI	proteinmpnn_test_binder_nonbinder/out/alignment/423p_with_pep.tsv	423p/423p
HVSTYAAFVQTHRPTGEFMFEFDEDEMFYVDLDKKETVWHLEEFGQAFSFEAQGGLANIAILNNNLNTLIQRSNHTQ/VYQLRQECYAFNGTQRFLERYIYNREEFVRFDSDVGEFRAVTELGRPDEDYWNSQKDLLEEERAVPDRMCRHNYELDEAVTLQRR/EKKYFFATQFEPLAA	proteinmpnn_test_binder_nonbinder/out/alignment/424p_with_pep.tsv	424p/424p
DHVASCGVNLYQFYGPSGQYTHEFDGDEQFYVDLERKETAWRWPEFSKFGGFDPQGALRNMAVAKHNLNIMIKRYNSTA/FVFQFKGMCYFTNGTERVRLVTRYIYNREEYARFDSDVGVYRAVTPQGRPDAEYWNSQKEVLEGTRAELDTVCRHNYEVAFRGILQRR/AAFLHATDLLPACAA	proteinmpnn_test_binder_nonbinder/out/alignment/425p_with_pep.tsv	425p/425p
HVSTYAAFVQTHRPTGEFMFEFDEDEQFYVDLDKKETVWHLEEFGRAFSFEAQGGLANIAILNNNLNTLIQRSNHTQ/VYQGRQECYAFNGTQRFLERYIYNREEYARFDSDVGEFRAVTELGRPAAEYWNSQKDILEEKRAVPDRVCRHNYELDEAVTLQRR/EKKYFAATQFEQLAA	proteinmpnn_test_binder_nonbinder/out/alignment/426p_with_pep.tsv	426p/426p
HVSTYAMFVQTHRPTGEFMFEFDEDEMFYVDLDKKETVWHLEEFGQAFSFEAQGGLANIAISNNNLNTLIQRSNHTQ/LFQGRQECYAFNGTQRFLERYIYNREEFVRFDSDVGEFRAVTELGRPDEEYWNSQKDILEEKRAVPDRMCRHNYELGGPMTLQRR/EKKYFAATQLEPLAA	proteinmpnn_test_binder_nonbinder/out/alignment/427p_with_pep.tsv	427p/427p
HVSTYAAFVQTHRPTGEFMFEFDEDEMFYVDLDKKETVWHLEEFGQAFSFEAQGGLANIAILNNNLNTLIQRSNHTQ/VYQLRQECYAFNGTQRFLERYIYNREEFVRFDSDVGEFRAVTELGRPDEDYWNSQKDLLEEERAVPDRMCRHNYELDEAVTLQRR/FKKYFAATQFEPLAA	proteinmpnn_test_binder_nonbinder/out/alignment/428p_with_pep.tsv	428p/428p
HVSTYAMFVQTHRPTGEFMFEFDEDEMFYVDLDKKETVWHLEEFGQAFSFEAQGGLANIAISNNNLNTLIQRSNHTQ/LFQGRQECYAFNGTQRFLERYIYNREEFVRFDSDVGEFRAVTELGRPDEEYWNSQKDILEEKRAVPDRMCRHNYELGGPMTLQRR/VYGIFYATSFLDLYR	proteinmpnn_test_binder_nonbinder/out/alignment/429p_with_pep.tsv	429p/429p
HVSTYAAFVQTHRPTGEFMFEFDEDEMFYVDLDKKETVWHLEEFGQAFSFEAQGGLANIAILNNNLNTLIQRSNHTQ/LFQGRQECYAFNGTQRFLERYIYNREEFVRFDSDVGEFRAVTELGRPDEEYWNSQKDILEEERAVPDRMCRHNYELGGPMTLQRR/GAQLGELYYAIYKAS	proteinmpnn_test_binder_nonbinder/out/alignment/430p_with_pep.tsv	430p/430p
HVSTYAAFVQTHRPTGEFMFEFDEDEMFYVDLDKKETVWHLEEFGQAFSFEAQGGLANIAILNNNLNTLIQRSNHTQ/LFQGRQECYAFNGTQRFLERYIYNREEFARFDSDVGEFRAVTELGRPAAEYWNSQKDILEEKRAVPDRMCRHNYELGGPMTLQRR/GWIISNIFGAIPVLA	proteinmpnn_test_binder_nonbinder/out/alignment/431p_with_pep.tsv	431p/431p
HVSTYAAFVQTHRPTGEFMFEFDEDEQFYVDLDKKETVWHLEEFGRAFSFEAQGGLANIAILNNNLNTLIQRSNHTQ/VHQLRQECYAFNGTQRFLERYIYNREEFVRFDSDVGEFRAVTELGRPDEDYWNSQKDLLEEKRAVPDRVCRHNYELDEAVTLQRR/FKKYFAATQFEPLAA	proteinmpnn_test_binder_nonbinder/out/alignment/432p_with_pep.tsv	432p/432p
HVSTYAAFVQTHRPTGEFMFEFDEDEMFYVDLDKKETVWHLEEFGQAFSFEAQGGLANIAILNNNLNTLIQRSNHTQ/LFQGRQECYAFNGTQRFLERYIYNREEFARFDSDVGEFRAVTELGRPAAEYWNSQKDILEEKRAVPDRMCRHNYELGGPMTLQRR/EKKYFAATRFEPLAA	proteinmpnn_test_binder_nonbinder/out/alignment/433p_with_pep.tsv	433p/433p
DHVASCGVNLYQFYGPSGQYTHEFDGDEQFYVDLERKETAWRWPEFSKFGGFDPQGALRNMAVAKHNLNIMIKRYNSTA/FVFQFKGMCYFTNGTERVRLVTRYIYNREEYARFDSDVGVYRAVTPQGRPDAEYWNSQKEVLEGTRAELDTVCRHNYEVAFRGILQRR/INHPTAAAIAYGLDR	proteinmpnn_test_binder_nonbinder/out/alignment/434p_with_pep.tsv	434p/434p
HVSTYAAFVQTHRPTGEFMFEFDEDEMFYVDLDKKETVWHLEEFGQAFSFEAQGGLANIAILNNNLNTLIQRSNHTQ/VYQLRQECYAFNGTQRFLERYIYNREEFVRFDSDVGEFRAVTELGRPDEDYWNSQKDLLEEERAVPDRMCRHNYELDEAVTLQRR/NKKYFAATQFEPLAA	proteinmpnn_test_binder_nonbinder/out/alignment/435p_with_pep.tsv	435p/435p
DHVASYGVNLYQSYGPSGQFTHEFDGDEEFYVDLERKETVWKLPLFHRLRFDPQFALTNIAVLKHNLNILIKRSNSTA/FVYQFKAMCYFTNGTERVRYVTRYIYNREEYARFDSDVEVYRAVTPLGPPDAEYWNSQKEVLERTRAELDTVCRHNYQLELRTTLQRR/NPFFAVTALTIAYLVKK	proteinmpnn_test_binder_nonbinder/out/alignment/436p_with_pep.tsv	436p/436p
DHVASCGVNLYQFYGPSGQYTHEFDGDEEFYVDLERKETAWRWPEFSKFGGFDPQGALRNMAVAKHNLNIMIKRYNSTA/FVYQFKGLCYFTNGTERVRGVTRHIYNREEYVRFDSDVGVYRAVTPQGRPVAEYWNSQKEVLEGARASVDRVCRHNYEVAYRGILQRR/SQDLELSWNLNGLQAI	proteinmpnn_test_binder_nonbinder/out/alignment/437p_with_pep.tsv	437p/437p
HVSTYAAFVQTHRPTGEFMFEFDEDEMFYVDLDKKETVWHLEEFGQAFSFEAQGGLANIAILNNNLNTLIQRSNHTQ/LFQGRQECYAFNGTQRFLERYIYNREEFARFDSDVGEFRAVTELGRPAAEYWNSQKDILEEKRAVPDRMCRHNYELGGPMTLQRR/WKKYFAATQFEPLAA	proteinmpnn_test_binder_nonbinder/out/alignment/438p_with_pep.tsv	438p/438p
DHVASCGVNLYQFYGPSGQYTHEFDGDEQFYVDLERKETAWRWPEFSKFGGFDPQGALRNMAVAKHNLNIMIKRYNSTA/FVYQFKGLCYFTNGTERVRGVTRHIYNREEYVRFDSDVGVYRAVTPQGRPVAEYWNSQKEVLEGARASVDRVCRHNYEVAYRGILQRR/LASVAMCRTPFSLAE	proteinmpnn_test_binder_nonbinder/out/alignment/439p_with_pep.tsv	439p/439p
HVSTYAAFVQTHRPTGEFMFEFDEDEQFYVDLDKKETVWHLEEFGRAFSFEAQGGLANIAILNNNLNTLIQRSNHTQ/VHQLRQECYAFNGTQRFLERYIYNREEFVRFDSDVGEFRAVTELGRPDEDYWNSQKDLLEEKRAVPDRVCRHNYELDEAVTLQRR/EKKYFIATQFEPLAA	proteinmpnn_test_binder_nonbinder/out/alignment/440p_with_pep.tsv	440p/440p
HVSTYAMFVQTHRPTGEFMFEFDEDEMFYVDLDKKETVWHLEEFGQAFSFEAQGGLANIAISNNNLNTLIQRSNHTQ/LFQGRQECYAFNGTQRFLERYIYNREEFVRFDSDVGEFRAVTELGRPDEEYWNSQKDILEEKRAVPDRMCRHNYELGGPMTLQRR/EKKYFAETQFEPLAA	proteinmpnn_test_binder_nonbinder/out/alignment/441p_with_pep.tsv	441p/441p
HVSTYAAFVQTHRPTGEFMFEFDEDEMFYVDLDKKETVWHLEEFGQAFSFEAQGGLANIAILNNNLNTLIQRSNHTQ/LFQGRQECYAFNGTQRFLERYIYNREEFARFDSDVGEFRAVTELGRPAAEYWNSQKDILEEKRAVPDRMCRHNYELGGPMTLQRR/EHKYFAATQFEPLAA	proteinmpnn_test_binder_nonbinder/out/alignment/442p_with_pep.tsv	442p/442p
DHVASCGVNLYQFYGPSGQYTHEFDGDEQFYVDLERKETAWRWPEFSKFGGFDPQGALRNMAVAKHNLNIMIKRYNSTA/FVFQFKGMCYFTNGTERVRLVTRYIYNREEYARFDSDVGVYRAVTPQGRPDAEYWNSQKEVLEGTRAELDTVCRHNYEVAFRGILQRR/NPMTVFWSKMAQSMT	proteinmpnn_test_binder_nonbinder/out/alignment/443p_with_pep.tsv	443p/443p
HVSTYAMFVQTHRPTGEFMFEFDEDEMFYVDLDKKETVWHLEEFGQAFSFEAQGGLANIAISNNNLNTLIQRSNHTQ/LFQGRQECYAFNGTQRFLERYIYNREEFVRFDSDVGEFRAVTELGRPDEEYWNSQKDILEEKRAVPDRMCRHNYELGGPMTLQRR/EKKYFQATQFEPLAA	proteinmpnn_test_binder_nonbinder/out/alignment/444p_with_pep.tsv	444p/444p
HVSTYAAFVQTHRPTGEFMFEFDEDEQFYVDLDKKETVWHLEEFGRAFSFEAQGGLANIAILNNNLNTLIQRSNHTQ/VYQGRQECYAFNGTQRFLERYIYNREEYARFDSDVGEFRAVTELGRPAAEYWNSQKDILEEKRAVPDRVCRHNYELDEAVTLQRR/ECKYFAATQFEPLAA	proteinmpnn_test_binder_nonbinder/out/alignment/445p_with_pep.tsv	445p/445p
HVSTYAAFVQTHRPTGEFMFEFDEDEMFYVDLDKKETVWHLEEFGQAFSFEAQGGLANIAILNNNLNTLIQRSNHTQ/LFQGRQECYAFNGTQRFLERYIYNREEFARFDSDVGEFRAVTELGRPAAEYWNSQKDILEEKRAVPDRMCRHNYELGGPMTLQRR/EKKYFAPTQFEPLAA	proteinmpnn_test_binder_nonbinder/out/alignment/446p_with_pep.tsv	446p/446p
DHVASYGVNLYQSYGPSGQYTHEFDGDEQFYVDLGRKETVWCLPVLRQFRFDPQFALTNIAVLKHNLNSLIKRSNSTA/FVYQFKAMCYFTNGTERVRYVTRYIYNREEYARFDSDVEVYRAVTPLGPPDAEYWNSQKEVLERTRAELDTVCRHNYQLELRTTLQRR/AFKIAATAANAAPTN	proteinmpnn_test_binder_nonbinder/out/alignment/447p_with_pep.tsv	447p/447p
DHVASCGVNLYQFYGPSGQYTHEFDGDEEFYVDLERKETAWRWPEFSKFGGFDPQGALRNMAVAKHNLNIMIKRYNSTA/FVYQFKGLCYFTNGTERVRGVTRHIYNREEYVRFDSDVGVYRAVTPQGRPVAEYWNSQKEVLEGARASVDRVCRHNYEVAYRGILQRR/SQDLELSWNLNGLCAY	proteinmpnn_test_binder_nonbinder/out/alignment/448p_with_pep.tsv	448p/448p
HVSTYAAFVQTHRPTGEFMFEFDEDEMFYVDLDKKETVWHLEEFGQAFSFEAQGGLANIAILNNNLNTLIQRSNHTQ/VYQLRQECYAFNGTQRFLERYIYNREEFVRFDSDVGEFRAVTELGRPDEDYWNSQKDLLEEKRAVPDRVCRHNYELDEAVTLQRR/YQIAFSRGNRAFIAI	proteinmpnn_test_binder_nonbinder/out/alignment/449p_with_pep.tsv	449p/449p
HVSTYAAFVQTHRPTGEFMFEFDEDEQFYVDLDKKETVWHLEEFGRAFSFEAQGGLANIAILNNNLNTLIQRSNHTQ/VYQGRQECYAFNGTQRFLERYIYNREEYARFDSDVGEFRAVTELGRPAAEYWNSQKDILEEKRAVPDRVCRHNYELDEAVTLQRR/EKKYFAATQFEPLAT	proteinmpnn_test_binder_nonbinder/out/alignment/451p_with_pep.tsv	451p/451p
HVSTYAAFVQTHRPTGEFMFEFDEDEQFYVDLDKKETVWHLEEFGRAFSFEAQGGLANIAILNNNLNTLIQRSNHTQ/VYQGRQECYAFNGTQRFLERYIYNREEYARFDSDVGEFRAVTELGRPAAEYWNSQKDILEEKRAVPDRVCRHNYELDEAVTLQRR/EKKYFAAVQFEPLAA	proteinmpnn_test_binder_nonbinder/out/alignment/450p_with_pep.tsv	450p/450p
HVSTYAAFVQTHRPTGEFMFEFDEDEMFYVDLDKKETVWHLEEFGQAFSFEAQGGLANIAILNNNLNTLIQRSNHTQ/LFQGRQECYAFNGTQRFLERYIYNREEFARFDSDVGEFRAVTELGRPAAEYWNSQKDILEEKRAVPDRMCRHNYELGGPMTLQRR/EKKYFAATQFEPCAA	proteinmpnn_test_binder_nonbinder/out/alignment/452p_with_pep.tsv	452p/452p
HVSTYAAFVQTHRPTGEFMFEFDEDEMFYVDLDKKETVWHLEEFGQAFSFEAQGGLANIAILNNNLNTLIQRSNHTQ/VYQLRQECYAFNGTQRFLERYIYNREEFVRFDSDVGEFRAVTELGRPDEDYWNSQKDLLEEKRAVPDRVCRHNYELDEAVTLQRR/AFKVAATAANAAPAF	proteinmpnn_test_binder_nonbinder/out/alignment/453p_with_pep.tsv	453p/453p
HVSTYAAFVQTHRPTGEFMFEFDEDEMFYVDLDKKETVWHLEEFGQAFSFEAQGGLANIAILNNNLNTLIQRSNHTQ/LFQGRQECYAFNGTQRFLERYIYNREEFARFDSDVGEFRAVTELGRPAAEYWNSQKDILEEKRAVPDRMCRHNYELGGPMTLQRR/EKKTFAATQFEPLAA	proteinmpnn_test_binder_nonbinder/out/alignment/454p_with_pep.tsv	454p/454p
HVSTYAAFVQTHRPTGEFMFEFDEDEQFYVDLDKKETVWHLEEFGRAFSFEAQGGLANIAILNNNLNTLIQRSNHTQ/VHQLRQECYAFNGTQRFLERYIYNREEFVRFDSDVGEFRAVTELGRPDEDYWNSQKDLLEEKRAVPDRVCRHNYELDEAVTLQRR/AFKVAAVAANAAPAN	proteinmpnn_test_binder_nonbinder/out/alignment/455p_with_pep.tsv	455p/455p
HVSTYAAFVQTHRPTGEFMFEFDEDEMFYVDLDKKETVWHLEEFGQAFSFEAQGGLANIAILNNNLNTLIQRSNHTQ/LFQGRQECYAFNGTQRFLERYIYNREEFARFDSDVGEFRAVTELGRPAAEYWNSQKDILEEKRAVPDRMCRHNYELGGPMTLQRR/EKKYFAATQFEPLYA	proteinmpnn_test_binder_nonbinder/out/alignment/456p_with_pep.tsv	456p/456p
HVSTYAAFVQTHRPTGEFMFEFDEDEMFYVDLDKKETVWHLEEFGQAFSFEAQGGLANIAILNNNLNTLIQRSNHTQ/VYQLRQECYAFNGTQRFLERYIYNREEFVRFDSDVGEFRAVTELGRPDEDYWNSQKDLLEEKRAVPDRVCRHNYELDEAVTLQRR/AFKVAATAANAAPAR	proteinmpnn_test_binder_nonbinder/out/alignment/457p_with_pep.tsv	457p/457p
HVSTYAAFVQTHRPTGEFMFEFDEDEMFYVDLDKKETVWHLEEFGQAFSFEAQGGLANIAILNNNLNTLIQRSNHTQ/VYQLRQECYAFNGTQRFLERYIYNREEFVRFDSDVGEFRAVTELGRPDEDYWNSQKDLLEEERAVPDRMCRHNYELDEAVTLQRR/EKKYFMATQFEPLAA	proteinmpnn_test_binder_nonbinder/out/alignment/459p_with_pep.tsv	459p/459p
HVSTYAAFVQTHRPTGEFMFEFDEDEMFYVDLDKKETVWHLEEFGQAFSFEAQGGLANIAILNNNLNTLIQRSNHTQ/VYQLRQECYAFNGTQRFLERYIYNREEFVRFDSDVGEFRAVTELGRPDEDYWNSQKDLLEEKRAVPDRVCRHNYELDEAVTLQRR/YKKLRTSSFALNLPT	proteinmpnn_test_binder_nonbinder/out/alignment/458p_with_pep.tsv	458p/458p
HVSTYAAFVQTHRPTGEFMFEFDEDEMFYVDLDKKETVWHLEEFGQAFSFEAQGGLANIAILNNNLNTLIQRSNHTQ/VYQLRQECYAFNGTQRFLERYIYNREEFVRFDSDVGEFRAVTELGRPDEDYWNSQKDLLEEERAVPDRMCRHNYELDEAVTLQRR/RKKYFAATQFEPLAA	proteinmpnn_test_binder_nonbinder/out/alignment/460p_with_pep.tsv	460p/460p
HVSTYAAFVQTHRPTGEFMFEFDEDEQFYVDLDKKETVWHLEEFGRAFSFEAQGGLANIAILNNNLNTLIQRSNHTQ/VHQLRQECYAFNGTQRFLERYIYNREEFVRFDSDVGEFRAVTELGRPDEDYWNSQKDLLEEKRAVPDRVCRHNYELDEAVTLQRR/EKKYFAITQFEPLAA	proteinmpnn_test_binder_nonbinder/out/alignment/462p_with_pep.tsv	462p/462p
HVSTYAMFVQTHRPTGEFMFEFDEDEMFYVDLDKKETVWHLEEFGQAFSFEAQGGLANIAISNNNLNTLIQRSNHTQ/LFQGRQECYAFNGTQRFLERYIYNREEFVRFDSDVGEFRAVTELGRPDEEYWNSQKDILEEKRAVPDRMCRHNYELGGPMTLQRR/KSIIIPFIAYFVLMH	proteinmpnn_test_binder_nonbinder/out/alignment/461p_with_pep.tsv	461p/461p
HVSTYAAFVQTHRPTGEFMFEFDEDEMFYVDLDKKETVWHLEEFGQAFSFEAQGGLANIAILNNNLNTLIQRSNHTQ/VYQLRQECYAFNGTQRFLERYIYNREEFVRFDSDVGEFRAVTELGRPDEDYWNSQKDLLEEERAVPDRMCRHNYELDEAVTLQRR/EKKYFCATQFEPLAA	proteinmpnn_test_binder_nonbinder/out/alignment/463p_with_pep.tsv	463p/463p
HVSTYAAFVQTHRPTGEFMFEFDEDEMFYVDLDKKETVWHLEEFGQAFSFEAQGGLANIAILNNNLNTLIQRSNHTQ/LFQGRQECYAFNGTQRFLERYIYNREEFARFDSDVGEFRAVTELGRPAAEYWNSQKDILEEKRAVPDRMCRHNYELGGPMTLQRR/EKKYFAATQMEPLAA	proteinmpnn_test_binder_nonbinder/out/alignment/464p_with_pep.tsv	464p/464p
DHVASCGVNLYQFYGPSGQYTHEFDGDEQFYVDLERKETAWRWPEFSKFGGFDPQGALRNMAVAKHNLNIMIKRYNSTA/FVFQFKGMCYFTNGTERVRLVTRYIYNREEYARFDSDVGVYRAVTPQGRPDAEYWNSQKEVLEGTRAELDTVCRHNYEVAFRGILQRR/YVAWMSATAALAREA	proteinmpnn_test_binder_nonbinder/out/alignment/465p_with_pep.tsv	465p/465p
DHVASYGVNLYQSYGPSGQYTHEFDGDEQFYVDLGRKETVWCLPVLRQFRFDPQFALTNIAVLKHNLNSLIKRSNSTA/FVYQFKAMCYFTNGTERVRYVTRYIYNREEYARFDSDVEVYRAVTPLGPPDAEYWNSQKEVLERTRAELDTVCRHNYQLELRTTLQRR/INEPTAAAILYGLDR	proteinmpnn_test_binder_nonbinder/out/alignment/466p_with_pep.tsv	466p/466p
HVSTYAAFVQTHRPTGEFMFEFDEDEMFYVDLDKKETVWHLEEFGQAFSFEAQGGLANIAILNNNLNTLIQRSNHTQ/VYQLRQECYAFNGTQRFLERYIYNREEFVRFDSDVGEFRAVTELGRPDEDYWNSQKDLLEEERAVPDRMCRHNYELDEAVTLQRR/EKKYMAATQFEPLAA	proteinmpnn_test_binder_nonbinder/out/alignment/467p_with_pep.tsv	467p/467p
HVSTYAAFVQTHRPTGEFMFEFDEDEMFYVDLDKKETVWHLEEFGQAFSFEAQGGLANIAILNNNLNTLIQRSNHTQ/VYQLRQECYAFNGTQRFLERYIYNREEFVRFDSDVGEFRAVTELGRPDEDYWNSQKDLLEEERAVPDRMCRHNYELDEAVTLQRR/EKKYFQATQFEPLAA	proteinmpnn_test_binder_nonbinder/out/alignment/468p_with_pep.tsv	468p/468p
DHVASYGVNLYQSYGPSGQYTHEFDGDEQFYVDLGRKETVWCLPVLRQFRFDPQFALTNIAVLKHNLNSLIKRSNSTA/FVYQFKGMCYFTNGTERVRLVSRSIYNREEIVRFDSDVGEFRAVTLLGLPAAEYWNSQKDILERKRAAVDRVCRHNYQLELRTTLQRR/APFIEQEGPEYFDQE	proteinmpnn_test_binder_nonbinder/out/alignment/469p_with_pep.tsv	469p/469p
HVSTYAAFVQTHRPTGEFMFEFDEDEMFYVDLDKKETVWHLEEFGQAFSFEAQGGLANIAILNNNLNTLIQRSNHTQ/LFQGRQECYAFNGTQRFLERYIYNREEFARFDSDVGEFRAVTELGRPAAEYWNSQKDILEEKRAVPDRMCRHNYELGGPMTLQRR/FNNFTVSFWLRVPKV	proteinmpnn_test_binder_nonbinder/out/alignment/470p_with_pep.tsv	470p/470p
HVSTYAMFVQTHRPTGEFMFEFDEDEMFYVDLDKKETVWHLEEFGQAFSFEAQGGLANIAISNNNLNTLIQRSNHTQ/LFQGRQECYAFNGTQRFLERYIYNREEFVRFDSDVGEFRAVTELGRPDEEYWNSQKDILEEKRAVPDRMCRHNYELGGPMTLQRR/EKKYFAAFQFEPLAA	proteinmpnn_test_binder_nonbinder/out/alignment/471p_with_pep.tsv	471p/471p
HVSTYAAFVQTHRPTGEFMFEFDEDEMFYVDLDKKETVWHLEEFGQAFSFEAQGGLANIAILNNNLNTLIQRSNHTQ/VYQLRQECYAFNGTQRFLERYIYNREEFVRFDSDVGEFRAVTELGRPDEDYWNSQKDLLEEERAVPDRMCRHNYELDEAVTLQRR/ESKYFAATQFEPLAA	proteinmpnn_test_binder_nonbinder/out/alignment/472p_with_pep.tsv	472p/472p
HVSTYAAFVQTHRPTGEFMFEFDEDEMFYVDLDKKETVWHLEEFGQAFSFEAQGGLANIAILNNNLNTLIQRSNHTQ/VYQLRQECYAFNGTQRFLERYIYNREEFVRFDSDVGEFRAVTELGRPDEDYWNSQKDLLEEERAVPDRMCRHNYELDEAVTLQRR/EKKYFAATQFEPLYA	proteinmpnn_test_binder_nonbinder/out/alignment/473p_with_pep.tsv	473p/473p
DHVASYGVNLYQSYGPSGQYTHEFDGDEQFYVDLGRKETVWCLPVLRQFRFDPQFALTNIAVLKHNLNSLIKRSNSTA/FVYQFKAMCYFTNGTERVRYVTRYIYNREEYARFDSDVEVYRAVTPLGPPDAEYWNSQKEVLERTRAELDTVCRHNYQLELRTTLQRR/TIAAMMTSPLSVASM	proteinmpnn_test_binder_nonbinder/out/alignment/474p_with_pep.tsv	474p/474p
DHVASCGVNLYQFYGPSGQYTHEFDGDEQFYVDLERKETAWRWPEFSKFGGFDPQGALRNMAVAKHNLNIMIKRYNSTA/FVFQFKGMCYFTNGTERVRLVTRYIYNREEYARFDSDVGVYRAVTPQGRPDAEYWNSQKEVLEGTRAELDTVCRHNYEVAFRGILQRR/DVNAGFKAAVAAAAN	proteinmpnn_test_binder_nonbinder/out/alignment/475p_with_pep.tsv	475p/475p
HVSTYAAFVQTHRPTGEFMFEFDEDEMFYVDLDKKETVWHLEEFGQAFSFEAQGGLANIAILNNNLNTLIQRSNHTQ/VYQLRQECYAFNGTQRFLERYIYNREEFVRFDSDVGEFRAVTELGRPDEDYWNSQKDLLEEERAVPDRMCRHNYELDEAVTLQRR/EMKYFAATQFEPLAA	proteinmpnn_test_binder_nonbinder/out/alignment/476p_with_pep.tsv	476p/476p
HVSTYAAFVQTHRPTGEFMFEFDEDEMFYVDLDKKETVWHLEEFGQAFSFEAQGGLANIAILNNNLNTLIQRSNHTQ/VYQLRQECYAFNGTQRFLERYIYNREEFVRFDSDVGEFRAVTELGRPDEDYWNSQKDLLEEERAVPDRMCRHNYELDEAVTLQRR/EKKYFAAQQFEPLAA	proteinmpnn_test_binder_nonbinder/out/alignment/477p_with_pep.tsv	477p/477p
HVSTYAAFVQTHRPTGEFMFEFDEDEQFYVDLDKKETVWHLEEFGRAFSFEAQGGLANIAILNNNLNTLIQRSNHTQ/VHQLRQECYAFNGTQRFLERYIYNREEFVRFDSDVGEFRAVTELGRPDEDYWNSQKDLLEEKRAVPDRVCRHNYELDEAVTLQRR/AFKVAATATNAAPAN	proteinmpnn_test_binder_nonbinder/out/alignment/478p_with_pep.tsv	478p/478p
HVSTYAAFVQTHRPTGEFMFEFDEDEQFYVDLDKKETVWHLEEFGRAFSFEAQGGLANIAILNNNLNTLIQRSNHTQ/VHQLRQECYAFNGTQRFLERYIYNREEFVRFDSDVGEFRAVTELGRPDEDYWNSQKDLLEEKRAVPDRVCRHNYELDEAVTLQRR/AFKVAAFAANAAPAN	proteinmpnn_test_binder_nonbinder/out/alignment/479p_with_pep.tsv	479p/479p
HVSTYAMFVQTHRPTGEFMFEFDEDEMFYVDLDKKETVWHLEEFGQAFSFEAQGGLANIAISNNNLNTLIQRSNHTQ/LFQGRQECYAFNGTQRFLERYIYNREEFVRFDSDVGEFRAVTELGRPDEEYWNSQKDILEEKRAVPDRMCRHNYELGGPMTLQRR/ISPSFLVYSFFVHDL	proteinmpnn_test_binder_nonbinder/out/alignment/480p_with_pep.tsv	480p/480p
HVSTYAMFVQTHRPTGEFMFEFDEDEMFYVDLDKKETVWHLEEFGQAFSFEAQGGLANIAISNNNLNTLIQRSNHTQ/LFQGRQECYAFNGTQRFLERYIYNREEFVRFDSDVGEFRAVTELGRPDEEYWNSQKDILEEKRAVPDRMCRHNYELGGPMTLQRR/VKKYFAATQFEPLAA	proteinmpnn_test_binder_nonbinder/out/alignment/481p_with_pep.tsv	481p/481p
DHVASCGVNLYQFYGPSGQYTHEFDGDEQFYVDLERKETAWRWPEFSKFGGFDPQGALRNMAVAKHNLNIMIKRYNSTA/FVYQFKGLCYFTNGTERVRGVTRHIYNREEYVRFDSDVGVYRAVTPQGRPVAEYWNSQKEVLEGARASVDRVCRHNYEVAYRGILQRR/FRELVRNCDLPVWLS	proteinmpnn_test_binder_nonbinder/out/alignment/483p_with_pep.tsv	483p/483p
HVSTYAAFVQTHRPTGEFMFEFDEDEMFYVDLDKKETVWHLEEFGQAFSFEAQGGLANIAILNNNLNTLIQRSNHTQ/VYQLRQECYAFNGTQRFLERYIYNREEFVRFDSDVGEFRAVTELGRPDEDYWNSQKDLLEEERAVPDRMCRHNYELDEAVTLQRR/EKKYFAATQFFPLAA	proteinmpnn_test_binder_nonbinder/out/alignment/482p_with_pep.tsv	482p/482p
HVSTYAAFVQTHRPTGEFMFEFDEDEMFYVDLDKKETVWHLEEFGQAFSFEAQGGLANIAILNNNLNTLIQRSNHTQ/VYQLRQECYAFNGTQRFLERYIYNREEFVRFDSDVGEFRAVTELGRPDEDYWNSQKDLLEEERAVPDRMCRHNYELDEAVTLQRR/EIKYFAATQFEPLAA	proteinmpnn_test_binder_nonbinder/out/alignment/484p_with_pep.tsv	484p/484p
HVSTYAMFVQTHRPTGEFMFEFDEDEMFYVDLDKKETVWHLEEFGQAFSFEAQGGLANIAISNNNLNTLIQRSNHTQ/LFQGRQECYAFNGTQRFLERYIYNREEFVRFDSDVGEFRAVTELGRPDEEYWNSQKDILEEKRAVPDRMCRHNYELGGPMTLQRR/EKKYFAATCFEPLAA	proteinmpnn_test_binder_nonbinder/out/alignment/486p_with_pep.tsv	486p/486p
HVSTYAAFVQTHRPTGEFMFEFDEDEMFYVDLDKKETVWHLEEFGQAFSFEAQGGLANIAILNNNLNTLIQRSNHTQ/VYQLRQECYAFNGTQRFLERYIYNREEFVRFDSDVGEFRAVTELGRPDEDYWNSQKDLLEEERAVPDRMCRHNYELDEAVTLQRR/ELKYFAATQFEPLAA	proteinmpnn_test_binder_nonbinder/out/alignment/485p_with_pep.tsv	485p/485p
HVSTYAAFVQTHRPTGEFMFEFDEDEQFYVDLDKKETVWHLEEFGRAFSFEAQGGLANIAILNNNLNTLIQRSNHTQ/VHQLRQECYAFNGTQRFLERYIYNREEFVRFDSDVGEFRAVTELGRPDEDYWNSQKDLLEEKRAVPDRVCRHNYELDEAVTLQRR/AFKVAITAANAAPAN	proteinmpnn_test_binder_nonbinder/out/alignment/487p_with_pep.tsv	487p/487p
HVSTYAMFVQTHRPTGEFMFEFDEDEMFYVDLDKKETVWHLEEFGQAFSFEAQGGLANIAISNNNLNTLIQRSNHTQ/LFQGRQECYAFNGTQRFLERYIYNREEFVRFDSDVGEFRAVTELGRPDEEYWNSQKDILEEKRAVPDRMCRHNYELGGPMTLQRR/FYNEKAFLLTTFDVS	proteinmpnn_test_binder_nonbinder/out/alignment/489p_with_pep.tsv	489p/489p
HVSTYAMFVQTHRPTGEFMFEFDEDEMFYVDLDKKETVWHLEEFGQAFSFEAQGGLANIAISNNNLNTLIQRSNHTQ/LFQGRQECYAFNGTQRFLERYIYNREEFVRFDSDVGEFRAVTELGRPDEEYWNSQKDILEEKRAVPDRMCRHNYELGGPMTLQRR/ESKYFAATQFEPLAA	proteinmpnn_test_binder_nonbinder/out/alignment/488p_with_pep.tsv	488p/488p
DHVASYGVNLYQSYGPSGQYTHEFDGDEQFYVDLGRKETVWCLPVLRQFRFDPQFALTNIAVLKHNLNSLIKRSNSTA/FVYQFKAMCYFTNGTERVRYVTRYIYNREEYARFDSDVEVYRAVTPLGPPDAEYWNSQKEVLERTRAELDTVCRHNYQLELRTTLQRR/DVKFCGGGQIVGGVY	proteinmpnn_test_binder_nonbinder/out/alignment/490p_with_pep.tsv	490p/490p
HVSTYAMFVQTHRPTGEFMFEFDEDEMFYVDLDKKETVWHLEEFGQAFSFEAQGGLANIAISNNNLNTLIQRSNHTQ/LFQGRQECYAFNGTQRFLERYIYNREEFVRFDSDVGEFRAVTELGRPDEEYWNSQKDILEEKRAVPDRMCRHNYELGGPMTLQRR/EGKYFAATQFEPLAA	proteinmpnn_test_binder_nonbinder/out/alignment/492p_with_pep.tsv	492p/492p
DHVASYGVNLYQSYGPSGQYTHEFDGDEQFYVDLGRKETVWCLPVLRQFRFDPQFALTNIAVLKHNLNSLIKRSNSTA/FVYQFKAMCYFTNGTERVRYVTRYIYNREEYARFDSDVEVYRAVTPLGPPDAEYWNSQKEVLERTRAELDTVCRHNYQLELRTTLQRR/DVNASFRAAMATTAN	proteinmpnn_test_binder_nonbinder/out/alignment/491p_with_pep.tsv	491p/491p
HVSTYAAFVQTHRPTGEFMFEFDEDEMFYVDLDKKETVWHLEEFGQAFSFEAQGGLANIAILNNNLNTLIQRSNHTQ/LFQGRQECYAFNGTQRFLERYIYNREEFARFDSDVGEFRAVTELGRPAAEYWNSQKDILEEKRAVPDRMCRHNYELGGPMTLQRR/EKCYFAATQFEPLAA	proteinmpnn_test_binder_nonbinder/out/alignment/495p_with_pep.tsv	495p/495p
HVSTYAAFVQTHRPTGEFMFEFDEDEMFYVDLDKKETVWHLEEFGQAFSFEAQGGLANIAILNNNLNTLIQRSNHTQ/VYQLRQECYAFNGTQRFLERYIYNREEFVRFDSDVGEFRAVTELGRPDEDYWNSQKDLLEEERAVPDRMCRHNYELDEAVTLQRR/EKKGFAATQFEPLAA	proteinmpnn_test_binder_nonbinder/out/alignment/493p_with_pep.tsv	493p/493p
HVSTYAAFVQTHRPTGEFMFEFDEDEQFYVDLDKKETVWHLEEFGRAFSFEAQGGLANIAILNNNLNTLIQRSNHTQ/LFQGRQECYAFNGTQRFLERYIYNREELVRFDSDVGEFRAVTELGRPEAEYWNSQKDILEEKRAVPDRMCRHNYELDEAVTLQRR/DKRLAAYLMLMRSPS	proteinmpnn_test_binder_nonbinder/out/alignment/494p_with_pep.tsv	494p/494p
HVSTYAAFVQTHRPTGEFMFEFDEDEQFYVDLDKKETVWHLEEFGRAFSFEAQGGLANIAILNNNLNTLIQRSNHTQ/VHQLRQECYAFNGTQRFLERYIYNREEFVRFDSDVGEFRAVTELGRPDEDYWNSQKDLLEEKRAVPDRVCRHNYELDEAVTLQRR/AFKVAAQAANAAPAN	proteinmpnn_test_binder_nonbinder/out/alignment/497p_with_pep.tsv	497p/497p
HVSTYAAFVQTHRPTGEFMFEFDEDEQFYVDLDKKETVWHLEEFGRAFSFEAQGGLANIAILNNNLNTLIQRSNHTQ/VHQLRQECYAFNGTQRFLERYIYNREEFVRFDSDVGEFRAVTELGRPDEDYWNSQKDLLEEKRAVPDRVCRHNYELDEAVTLQRR/EKKYFAATQFEALAA	proteinmpnn_test_binder_nonbinder/out/alignment/496p_with_pep.tsv	496p/496p
DHVASCGVNLYQFYGPSGQYTHEFDGDEQFYVDLERKETAWRWPEFSKFGGFDPQGALRNMAVAKHNLNIMIKRYNSTA/FVYQFKGLCYFTNGTERVRGVTRHIYNREEYVRFDSDVGVYRAVTPQGRPVAEYWNSQKEVLEGARASVDRVCRHNYEVAYRGILQRR/EYGNLSLSGIAQSASD	proteinmpnn_test_binder_nonbinder/out/alignment/498p_with_pep.tsv	498p/498p
HVSTYAAFVQTHRPTGEFMFEFDEDEQFYVDLDKKETVWHLEEFGRAFSFEAQGGLANIAILNNNLNTLIQRSNHTQ/VYQGRQECYAFNGTQRFLERYIYNREEYARFDSDVGEFRAVTELGRPAAEYWNSQKDILEEKRAVPDRVCRHNYELDEAVTLQRR/EEDIEIIPIQKEEY	proteinmpnn_test_binder_nonbinder/out/alignment/499p_with_pep.tsv	499p/499p
HVSTYAAFVQTHRPTGEFMFEFDEDEMFYVDLDKKETVWHLEEFGQAFSFEAQGGLANIAILNNNLNTLIQRSNHTQ/VYQLRQECYAFNGTQRFLERYIYNREEFVRFDSDVGEFRAVTELGRPDEDYWNSQKDLLEEERAVPDRMCRHNYELDEAVTLQRR/EKKYFAATQFEPEAA	proteinmpnn_test_binder_nonbinder/out/alignment/292p_with_pep.tsv	292p/292p
